sample_diagnosis	mappedTermLabel
t2 transitional cell carcinoma	BLADDER UROTHELIAL CARCINOMA
soft tissue neoplasm nos sarcomatoid carcinoma possibly of lung or pleural origin patient was registered as lung cancer nos with subtype of undifferentiated carcinoma final patient pathology report scattered viable malignant cells with treatment effect in background of extensive necrosis tumor involves chest wall and focally invades ribs revised in pdmr database as only sarcamatoid outgrowth observed no markers for lung cancer detected	Soft Tissue Neoplasm
colon adenocarcinoma	Colon Adenocarcinoma
pancreatic cancer intraductal papillary mucinous neoplasm (ipmn, main duct/mixed)	Pancreatic Intraductal Papillary_and_Mucinous Neoplasm
atypical teratoid/rhabdoid tumor	ATYPICAL TERATOID/RHABDOID TUMOR
invasive ductal carcinoma, not otherwise specified	INVASIVE DUCTAL CARCINOMA NOT OTHERWISE SPECIFIED
squamous cell lung carcinoma invasive  final pathology dx confirmed lymphovascular invasion present 711 hilar lymph nodes positive for metastatic tumor location of known metastases lymph nodestumor stagegrade moderately differentiated	Lung Squamous Cell Carcinoma
endometrioid endomet adenocar	ENDOMETRIAL ENDOMETRIOID ADENOCARCINOMA
squamous cell lung carcinoma +perineural invasion 211 hilar ln positive tumor stagegrade moderately differentiated	LUNG SQUAMOUS CELL CARCINOMA
chondrosarcoma location of known metastasis chest wall	Chondrosarcoma
lung adenocarcinoma final pathology dx confirmed solid predominant 100 invasive through visceral pleura lymphovascular invasion identified extensive necrosis  tumor gradestage pt3 pn0ho prostate adenocarcinoma treated with prostatectomy and remains on adt	LUNG ADENOCARCINOMA
transitional cell carcinoma	Bladder Urothelial Carcinoma
liporal cavity squam cell car final pathology dx confirmedprior historymelanoma - 2001glioma, who grade 34 - 2009metastatic merkel cell carcinoma ear, neck - 2013squamous cell carcinoma of the skin calf - 2014 tumor gradestage t4an1mx, moderately differentiated	LIP AND ORAL CAVITY SQUAMOUS CELL CARCINOMA
signet ring cell gastric adenocarcinoma	Gastric Signet Ring Cell Adenocarcinoma
colon cancer	Colon Cancer
lung cancer nos undifferentiated carcinoma final pathology dx confirmed poorly differentiated malignant neoplasm favor undifferentiated carcinoma per patchy staining for oscar cytokeratin extensive lymphatic invasion focal pleural invasion confirmed by movat staining findings may fit best with large cell undifferentiated carcinoma compatible with lung primary and has been staged as such the possibility that this represents metastasis cannot be entirely excluded tumor stagegrade pt2a pn0 ajcc 7th ed 2010 grade 4	Lung Carcinoma
ductal adenocarcinoma	PANCREATIC DUCTAL ADENOCARCINOMA
adenocarcinoma	Adenocarcinoma
uterine corpus carcinosarcoma	Uterine Corpus Carcinosarcoma
basal	Basal-Like Breast Carcinoma
endometrial adenocarcinoma	ENDOMETRIAL ADENOCARCINOMA
diffuse large b-cell lymphoma	DIFFUSE LARGE B-CELL LYMPHOMA
bronchogenic carcinoma	Bronchogenic Carcinoma
leiomyosarcoma	Leiomyosarcoma
non-cancerous	Hematopoietic and Lymphoid Cell Neoplasm
medulloblastoma 4	Medulloblastoma
ewing sarcoma	Kidney Ewing Sarcoma
unknown	SOFT TISSUE CANCER
osteosarcoma	BONE OSTEOSARCOMA
endometrial cancer endometrioid carcinoma, other variant	Endometrial Endometrioid Adenocarcinoma
gastrointestinal cancer nos appendiceal	Appendix Cancer
glioblastoma, idh-mutant	GLIOBLASTOMA IDH-MUTANT
acute myeloid leukemia with gene mutations	Acute Myeloid Leukemia with Gene Mutations
gastroesophageal junction adenocarcinoma	Gastroesophageal Junction Adenocarcinoma
adenocarcinoma - colon moderately differentiated final pathology dx confirmed low grade with mucinous features tumor invades to the interface of the muscularis propria and pericolonic tissue with very focal lymph-vascular space invasion identified  tumor stagegrade pt3n0 ajcc 7th edition low grade	COLON ADENOCARCINOMA
alveolar rhabdomyosarcoma	Alveolar Rhabdomyosarcoma
adenocarcinoma - colon location of known metastases liver	Colon Adenocarcinoma
rhabdomyosarcoma spindle cell	Spindle Cell Rhabdomyosarcoma
glioblastoma	GLIOBLASTOMA
ovary papillary carcinoma	Ovarian Serous Surface Papillary Adenocarcinoma
pancreatic cancer	Pancreatic Cancer
uterine cancer	UTERINE CANCER
osteosarcoma	OSTEOSARCOMA
undifferentiated round cell sarcoma	UNDIFFERENTIATED ROUND CELL SARCOMA
bladder urothelial carcinoma	Bladder Urothelial Carcinoma
ovarian carcinoma	Ovarian Carcinoma
sarcoma from lung met; unknown subtype	Sarcoma
t-cell acute lymphoblastic leukaemia	T ACUTE LYMPHOBLASTIC LEUKEMIA
urothelialbladder cancer, nos invasive bladder with squamous sarcomatoid differentiation high-grade	Bladder Urothelial Carcinoma
osteosarcoma	Childhood Osteosarcoma
non-rhabdo. soft tissue sarcoma	Soft Tissue Sarcoma
ewing sarcoma	Ewing Sarcoma
endometrial carcinoma	Endometrial Carcinoma
rcc, clear cell adenocarcinoma	Clear Cell Renal Cell Carcinoma
prostate carcinoma	Prostate Carcinoma
fusion negative rhabdomyosarcoma	FUSION-NEGATIVE RHABDOMYOSARCOMA
extracranial rhabdoid	RHABDOID TUMOR
hypodiploid b acute lymphoblastic leukemia	Hypodiploid B Acute Lymphoblastic Leukemia
rare cancers leiomyosarcoma	Uterine Corpus Leiomyosarcoma
kidney cancer renal cell carcinoma	Renal Cell Carcinoma
embryonal rhabdomyosarcoma	Embryonal Rhabdomyosarcoma
colon mucinous adenocarcinoma	COLON MUCINOUS ADENOCARCINOMA
high grade glioma nos	Recurrent Malignant Glioma
lung cancer	LUNG CANCER
endometrial clear cell adenocarcinoma	Endometrial Clear Cell Adenocarcinoma
female reprod system cancer nos carcinosarcoma final clinical histology carcinosarcoma of unknown origin not mesothelioma not ovarianlocation of primary disease unknown location of primary disease unknown	CARCINOSARCOMA
neuroblastoma	NEUROBLASTOMA
small cell lung carcinoma	LUNG SMALL CELL CARCINOMA
adenocarcinoma - stomach invasive poorly differentiated	GASTRIC ADENOCARCINOMA
non-small cell lung carcinoma	Lung Non-Small Cell Carcinoma
papillary serous cystadenocarcinoma	Papillary Serous Cystadenocarcinoma
glioblastoma, idh-wildtype	GLIOBLASTOMA IDH-WILDTYPE
ovarian epithelial cancer location of known metastases peritoneum	OVARIAN CARCINOMA
childhood acute megakaryoblastic leukemia	Childhood Acute Megakaryoblastic Leukemia
pleural sarcomatoid mesothelioma	Pleural Sarcomatoid Mesothelioma
nasopharyngeal carcinoma	Nasopharyngeal Carcinoma
adult glioblastoma multiforme	Adult Glioblastoma
uveal melanoma	UVEAL MELANOMA
natural killer cell lymphoblastic leukemia or lymphoma	Natural Killer Cell Lymphoblastic Leukemia/Lymphoma
small cell car extrapulmonary small cell cancer of the bladder patient was registered as urothelialbladder cancer, nos pdx pathology review changed diagnosis of model to small cell cancer of the bladder extrapulmonary the diagnosis was reclassified	Bladder Small Cell Neuroendocrine Carcinoma
h n squamous cell car nos invasive moderately differentiated final pathology tongue right - dx confirmed lymphovascular space invasion identified  212 lymph nodes at right neck levels 2 and 3  location of known metastases lymph node	Head and Neck Squamous Cell Carcinoma
undifferentiated sarcoma - not otherwise specified	Undifferentiated Sarcoma Not Otherwise Specified
fusion-negative rhabdomyosarcoma	FUSION-NEGATIVE RHABDOMYOSARCOMA
rhabdomyosarcoma alveolar	Alveolar Rhabdomyosarcoma
acute myeloid leukemia with myelodysplasia-related changes	Acute Myeloid Leukemia with Myelodysplasia-Related Changes
vulvar carcinoma	Vulvar Carcinoma
pancreatic ductal adenocarcinoma	PANCREATIC DUCTAL ADENOCARCINOMA
intrahepatic bile duct cancer intrahepatic cholangiocarcinoma	Liver and Intrahepatic Bile Duct Carcinoma
endometrial adenocarcinoma	Endometrial Adenocarcinoma
carcinosarcoma of the uterus final surgical pathology carcinosarcoma dx confirmed involvement of fimbriated surface of left fallopian tube present pathology from diagnostic biopsy  poorly differentiated endometrial adenocarcinoma, figo grade 3 the sections show epithelial component consistent with endometrioid adenocarcinoma and mesenchymal, homologous component  tumor gradestage figo grade 3location of known metastases fallopian tube	Uterine Carcinosarcoma
primitive neuroectodermal tumor	Primitive Neuroectodermal Tumor
childhood b acute lymphoblastic leukemia	Childhood B Acute Lymphoblastic Leukemia
acute myelomonocytic leukemia	Acute Myelomonocytic Leukemia
adult acute myeloid leukemia with inv(16)(p13.1q22); cbfb-myh11	Adult Acute Myeloid Leukemia with inv(16)(p13.1q22); CBFB-MYH11
embryonal tumors with multilayered rosettes	Embryonal Tumor with Multilayered Rosettes Not Otherwise Specified
h n squamous cell car nos keratinizing patient has a ho pleomorphic sarcoma from 2005 received chemoradiation resulting in stage iii osteonecrosis of the left mandibleho t1n0m0 low-grade mucoepidermoid carcinoma of the right parotid gland in 2011	Head and Neck Squamous Cell Carcinoma
clear cell renal cell carcinoma	CLEAR CELL RENAL CELL CARCINOMA
squamous cervical cancer	CERVICAL SQUAMOUS CELL CARCINOMA NOT OTHERWISE SPECIFIED
head and neck squamous cell carcinoma	Tongue Squamous Cell Carcinoma
soft tissue neoplasm nos pleomorphic tumor stagegrade high grade	SOFT TISSUE CANCER
adenocarcinoma - colon tumor gradestage pt3n1b	Colon Adenocarcinoma
intraductal carcinoma; noninfiltrating; nos	Ductal Breast Carcinoma In Situ
early t-cell precursor acute lymphoblastic leukemia	Early T Acute Lymphoblastic Leukemia
inflammatory breast carcinoma tumor stagegrade pt3n2amx	INFLAMMATORY BREAST CARCINOMA
hairy cell leukemia	Hairy Cell Leukemia
ductal breast carcinoma	Breast Ductal Carcinoma
ovarian granulosa cell tumor	Ovarian Granulosa Cell Tumor
peripheral t-cell lymphoma not otherwise specified	Peripheral T-Cell Lymphoma Not Otherwise Specified
primary central chondrosarcoma	Primary Central Chondrosarcoma
cervix cancer caucasian	CERVICAL CANCER
cervical carcinoma	Cervical Carcinoma
head and neck cancer: larynx	Laryngeal Cancer
uterine carcinosarcoma	Uterine Carcinosarcoma
germ cell tumor	Childhood Malignant Testicular Germ Cell Tumor
medulloblastoma	Medulloblastoma
malignant mixed mullerian tumor	MALIGNANT MIXED MESODERMAL (MULLERIAN) TUMOR
high grade serous ovarian cancer	HIGH GRADE OVARIAN SEROUS ADENOCARCINOMA
lung squamous cell carcinoma, basaloid	Lung Basaloid Squamous Cell  Carcinoma
endometrial cancer endometrial carcinoma with serous component	Endometrial Serous Adenocarcinoma
skin squamous cell carcinoma	SKIN SQUAMOUS CELL CARCINOMA
adenocarcinoma - colon invasive moderately differentiated signet ring cells and mucinous features final pathology dx confirmed with signet ring cells and mucinous features invasive into muscularis propria  tumor stagegrade pt2 n0	COLON ADENOCARCINOMA
neuroblastoma	Neuroblastoma
squamous cell carcinoma	Head and Neck Squamous Cell Carcinoma
ovarian cancer	OVARIAN CANCER
melanoma tumor stagegrade pt3an1bmx stage iiiblocation of known metastases lymph nodes	Cutaneous Melanoma
cervix cancer	Cervical Cancer
small cell carcinoma	Extrapulmonary Small Cell Carcinoma
tongue squamous cell carcinoma	Tongue Squamous Cell Carcinoma
head and neck cancer: lip and oral cavity squamous cell carcinoma	Tongue Squamous Cell Carcinoma
nhl, nos	Non-Hodgkin Lymphoma
leiomyosarcoma - uterus	Uterine Corpus Leiomyosarcoma
ampulla of vater adenocarcinoma	Ampulla of Vater Adenocarcinoma
malig periph nerve sheath tum pleomorphic sarcoma final pathology soft tissue left forearm resection dx confirmednote per epic patient has findings consistent with neurofibromatosis 1 this in conjunction with the observation this sarcoma is associated with a nerve supports the diagnosis of malignant peripheral nerve sheath tumor tumor gradestage high grade	Malignant Peripheral Nerve Sheath Tumor
lung adenocarcinoma tumor stagegrade t1bn0m0 poorly differentiated	LUNG ADENOCARCINOMA
sarcoma	Metastatic Bone Sarcoma
synovial sarcoma poorly differentiated final pathology dx confirmed high grade with direct intracardiac extension of the tumor mass extensive lymphovascular invasion including pulmonary veins pre-op thoracentesis mitotic activity 23 mitoses10 hpfs tumor gradestage fnclcc grade of 3 of 3 pt2bn0primary cardiaclocation of known metastases lung	Synovial Sarcoma
ovarian epithelial cancer serous adenocarcinoma final pathology  dx confirmed bilateral ovariesho medullary carcinoma of the breast no systemic treatment given tumor gradestage high-gradelocation of known metastases fallopian tube left peritoneum uterus myometrium peritoneum posterior cul-de-sac	OVARIAN SEROUS ADENOCARCINOMA
duodenal adenocarcinoma	Duodenal Adenocarcinoma
desmoplastic small round cell tumor	Childhood Desmoplastic Small Round Cell Tumor
glioblastoma idh mutant 4	GLIOBLASTOMA IDH-MUTANT
acute myeloid leukemia	Acute Myeloid Leukemia
pleural sarcomatoid mesothelioma	PLEURAL SARCOMATOID MESOTHELIOMA
mucinous adenocarcinoma	Lung Colloid Adenocarcinoma
splenic marginal zone lymphoma	Splenic Marginal Zone Lymphoma
ovarian cancer high grade serous carcinoma	HIGH GRADE OVARIAN SEROUS ADENOCARCINOMA
colorectal carcinoma	Colorectal Carcinoma
cholangiocar.- intra/extrahepatic	Cholangiocarcinoma
colorectal adenocarcinoma	Colorectal Adenocarcinoma
colon cancer	COLON CANCER
invasive ductal carcinoma not otherwise specified	INVASIVE DUCTAL CARCINOMA NOT OTHERWISE SPECIFIED
adenocarcinoma - colon poorly differentiated with mucinous differentiation final pathology dx confirmed tumor invade to subserosal soft tissue with lymphovascular space invasion tumor gradestage pt3pn0 ajcc 7th ed low grade	COLON ADENOCARCINOMA
oral cavity squamous cell carcinoma	Oral Cavity Squamous Cell Carcinoma
testicular embryonal carcinoma	Testicular Embryonal Carcinoma
pancreatic cancer squamous cell carcinoma	Pancreatic Squamous Cell Carcinoma
b acute lymphoblastic leukemia with t(9;22)(q34.1;q11.2); bcr-abl1	B Acute Lymphoblastic Leukemia with t(9;22)(q34.1;q11.2); BCR-ABL1
down syndrome acute lymphocytic leukemia	Acute Lymphoblastic Leukemia
urothelialbladder cancer nos papillary wextensive squamous differentiation final pathology dx confirmed papillary exophytic and partially endophytic with extension through the bladder wall perivesical fat and into circumferential margin focally tumor gradestage high-grade pt3a pn0 pnx	Bladder Papillary Urothelial Carcinoma
kidney rhabdoid cancer	Rhabdoid Tumor of the Kidney
gist	Gastrointestinal Stromal Tumor
non-small cell lung carcinoma	LUNG NON-SMALL CELL CARCINOMA
fusion-positive rhabdomyosarcoma	FUSION-POSITIVE RHABDOMYOSARCOMA
fusion positive rhabdomyosarcoma	FUSION-POSITIVE RHABDOMYOSARCOMA
ewing sarcoma	EWING SARCOMA
b acute lymphoblastic leukemia with t(1;19)(q23;p13.3); e2a-pbx1 (tcf3-pbx1)	B Acute Lymphoblastic Leukemia with t(1;19)(q23;p13.3); E2A-PBX1 (TCF3-PBX1)
pancreatic ductal adenocarcinoma	Pancreatic Ductal Adenocarcinoma
bladder cancer	Bladder Cancer
malignant fibrous histiocytoma undifferentiated pleomorphic sarcoma final pathology dx confirmed 80 viable tumor present with 20 hemorrhagiccystic tumor gradestage grade 2 moderately differentiateddisease recurrence at primary site upper arm l	Undifferentiated Pleomorphic Sarcoma
hepatoblastoma	Hepatoblastoma
squamous cell lung carcinoma	LUNG SQUAMOUS CELL CARCINOMA
cecum adenocarcinoma	CECUM ADENOCARCINOMA
melanoma	CUTANEOUS MELANOMA
high grade ovarian serous adenocarcinoma	High Grade Ovarian Serous Adenocarcinoma
h n squamous cell car, nos	HEAD AND NECK SQUAMOUS CELL CARCINOMA
rare cancers small intestine cancer	Small Intestinal Cancer
extrarenal rhabdoid tumor	Extrarenal Rhabdoid Tumor
adenocarcinoma - stomach tumor stagegrade invasive poorly differentiated	GASTRIC ADENOCARCINOMA
pancreatic cancer moderately differentiated adenocarcinoma	Pancreatic Moderately Differentiated Ductal Adenocarcinoma
fusion-negative rhabdomyosarcoma	Fusion-Negative Rhabdomyosarcoma
not collected	Lung Neoplasm
childhood t acute lymphoblastic leukemia	T ACUTE LYMPHOBLASTIC LEUKEMIA
colon adenocarcinoma	COLON ADENOCARCINOMA
papillary renal cell carcinoma	Papillary Renal Cell Carcinoma
ewing sarcoma/peripheral pnet	Ewing Sarcoma
carcinosarcoma	OVARIAN CARCINOSARCOMA
retinoblastoma	Retinoblastoma
b-cell precursor acute lymphoblastic leukemia	B Acute Lymphoblastic Leukemia
salivary gland cancer adenoid cystic carcinoma recurrent diseaselocation of known metastases pleura	Salivary Gland Adenoid Cystic Carcinoma
anaplastic thyroid carcinoma	Thyroid Gland Anaplastic Carcinoma
breast carcinoma	BREAST CARCINOMA
ovarian cancer, nos carcinosarcoma final pathology dx confirmed high-grade, predominantly serous carcinoma with sarcomatous elements of homologous and heterologous rhabdoid types metastatic sites of disease are entirely carcinomatous type, mostly serous carcinoma with lesser clear cell carcinoma component,  tumor grade stage pt4nxm1 figo grade 4 histologic grade 3 poorly to undifferentiatedlocation of known metastases uterine serosa, left ovary fallopian tube, omentum, umbilicus, pleural effusion+ for malignant cells adenocarcinoma	Ovarian Carcinosarcoma
breast adenocarcinoma	Breast Adenocarcinoma
lung carcinoma	Lung Carcinoma
ampulla of vater carcinoma	Ampulla of Vater Carcinoma
melanoma pathology biopsy showing atypical lentiginous melanocytic proliferation having spitzoid features location of known metastases lymph node	Cutaneous Melanoma
rectal mucinous adenocarcinoma	RECTAL MUCINOUS ADENOCARCINOMA
h & n squamous cell car. nos	Head and Neck Squamous Cell Carcinoma
uterine corpus sarcoma	Uterine Corpus Sarcoma
ependymoma	Ependymoma
unknown	Lung Cancer
adenocarcinomain	Adenocarcinoma
urothelial/bladder cancer, nos	Urinary System Cancer
gastrointestinal stromal tumor site of resection included spleen, kidney, distal pancreatectomy and retroperitoneal tumor	GASTROINTESTINAL STROMAL TUMOR
squamous cell carcinoma - anus transitional cell features recurrent disease at primary site	Squamous Cell Carcinoma
fibrosarcoma - not infantile	Fibrosarcoma
malignant fibrous histiocytoma myxofibrosarcoma tumor gradestage fnclcc grade 2	Myxofibrosarcoma
cecum adenocarcinoma	Cecum Adenocarcinoma
melanoma spindle cell type	Cutaneous Melanoma
pancreatic adenocarcinoma	Pancreatic Adenocarcinoma
breast cancer	Breast Cancer
adult acute megakaryoblastic leukemia	ACUTE MEGAKARYOBLASTIC LEUKEMIA
adenocarcinoma - rectum tumor gradestage ut3n1m0	RECTAL ADENOCARCINOMA
chronic eosinophilic leukemia	Chronic Eosinophilic Leukemia Not Otherwise Specified
adenocarcinoma	Colorectal Adenocarcinoma
medulloblastoma	MEDULLOBLASTOMA
merkel cell tumor	Merkel Cell Carcinoma
adult b acute lymphoblastic leukemia	Adult B Acute Lymphoblastic Leukemia
renal cell carcinoma	Renal Cell Carcinoma
oligodendroglioma	Oligodendroglioma
adenocarcinoma	Gallbladder Adenocarcinoma
fibrosarcoma	Soft Tissue Fibrosarcoma
intraductal micropapillary carcinoma	INTRADUCTAL MICROPAPILLARY BREAST CARCINOMA
pharyngeal squam cell carcinoma tonsil scc	PHARYNGEAL SQUAMOUS CELL CARCINOMA
rcc clear cell adenocarcinoma tumor gradestage grade 4	CLEAR CELL RENAL CELL CARCINOMA
primary effusion lymphoma	Primary Effusion Lymphoma
carcinosarcoma of the uterus mixed malignant mullerian tumor  recurrent diseaselocation of metastases colon	Uterine Carcinosarcoma
chondrosarcoma	Chondrosarcoma
cervical adenocarcinoma	CERVICAL ADENOCARCINOMA
melanotic neuroectodermal tumor	Melanotic Neuroectodermal Tumor
sclerosing subtype rhabdomyosarcoma	Sclerosing Rhabdomyosarcoma
vulvar cancer, nos	Vulvar Cancer
giant cell lung carcinoma	LUNG LARGE CELL CARCINOMA
renal cell carcinoma, nos	Renal Cell Carcinoma
adenocarcinoma - pancreas  wmucinous features final pathology dx confirmed with 5-10 of liver involved by metastasis tumor stagegrade grade iv moderately differentiatedlocation of known metastases lung multifocal liver carcinomatosis abdominal lymph nodes diaphragmconcurrent dx papillary rcc pax8+ ck7+ cd117- grade 1 and clear cell rcc pax8+ ck7- cd117-prior ho basel cell carcinoma and bladder cancer	PANCREATIC ADENOCARCINOMA
lung cancer, nos	Thoracic Cancer
invasive adenocarcinoma	Colon Adenocarcinoma
breast cancer other	Breast Cancer
lung adenocarcinoma tumor gradestage pt2n0m0, grade 3, stage ib ajcc, poorly differentiatedprimary site of disease lung left, upper lobe	Lung Adenocarcinoma
brain glioma	Malignant Brain Glioma
lung adenocarcinoma	lung adenocarcinoma
acute b lymphoblastic leukemia	B ACUTE LYMPHOBLASTIC LEUKEMIA
adenocarcinoma - colon recurrent disease	Colon Adenocarcinoma
atypical teratoid rhabdoid tumor 4	ATYPICAL TERATOID/RHABDOID TUMOR
lymphoma	LYMPHOMA
ovarian epithelial cancer	Ovarian Carcinoma
wilms	Wilms Tumor
gastric tubular adenocarcinoma	Gastric Tubular Adenocarcinoma
brain glioblastoma multiforme	Glioblastoma
neuroblastoma	Childhood Neuroblastoma
high grade sarcoma	Childhood Soft Tissue Sarcoma
undifferentiated carcinoma	Pancreatic Undifferentiated Carcinoma
low grade urothelial (transitional cell) carcinoma; tan0mn/a	Ureter Urothelial Carcinoma
luminal breast carcinoma	Breast Carcinoma
b-cell lymphoma	Refractory Lymphoma
osteosarcoma	Osteosarcoma
rcc clear cell adenocarcinoma final pathology dx confirmed with rhabdoid differentiation and extensive necrosis invasion into renal sinus adipose tissue through renal capsule with direct extension to left adrenal and spleen tumor deposits in hilar soft tissue with perineural invasion and lymphovascular invasion identified tumor gradestage whoisup grade 4 pt4 pn0location of known metastases hilar soft tissue	CLEAR CELL RENAL CELL CARCINOMA
non-small cell lung cancer, nos	Lung Non-Small Cell Carcinoma
melanoma recurrent diseaseprimary tumor stagegrade iia t3an0m0 current stage iiic	Cutaneous Melanoma
transitional cell car - uroth high-grade	UROTHELIAL CARCINOMA
lung small cell carcinoma	Lung Small Cell Carcinoma
invasive adenocarcinoma	Esophageal Adenocarcinoma
breast cancer infiltrating ductal carcinoma	Breast Ductal Carcinoma
adenocarcinoma - colon	Colon Adenocarcinoma
chronic myeloid leukemia	Myeloid Leukemia
gastric choriocarcinoma	Gastric Choriocarcinoma
pharyngeal squam. cell carcinoma	Pharyngeal Squamous Cell Carcinoma
female reprod. system cancer, nos	Female Reproductive System cancer
invasive breast carcinoma ductal tnbc staging t2n0	INVASIVE DUCTAL CARCINOMA NOT OTHERWISE SPECIFIED
pancreatic cancer not islets ductal adenocarcinoma poorly differentiated final pathology dx confirmed with microscopic tumor extension invading into duodenal wall and retroperitoneal soft tissue tumor gradestage grade 3	Pancreatic Ductal Adenocarcinoma
neuroendocrine cancer, nos	Neuroendocrine Carcinoma
anaplastic astrocytoma	Anaplastic Astrocytoma
melanoma ho right parotid mass ho premalignant melanoma final pathology dx confirmed involving intraparotid lymph node extranodal extension indentified location of known metastases parotid gland	CUTANEOUS MELANOMA
adenocarcinoma - pancreas final pathology dx confirmed tumor gradestage pt3n1mx	Pancreatic Adenocarcinoma
adenosquamous endometrial carcinoma	Endometrial Adenosquamous Carcinoma
rhabdoid cancer	cancer
ovarian serous adenocarcinoma	Ovarian Serous Adenocarcinoma
pancreatic cancer adenocarcinoma (nos)	Pancreatic Adenocarcinoma
gastric cancer nos exophytic adenocarcinoma location of known metastasis lymph node left supraclavicular	GASTRIC ADENOCARCINOMA
head and neck squamous cell carcinoma	HEAD AND NECK SQUAMOUS CELL CARCINOMA
invasive ductal carcinoma not otherwise specified	Invasive Ductal Carcinoma Not Otherwise Specified
adenocarcinoma - colon moderately to poorly differentiated final pathology dx confirmed with focal tumor budding tumor invades through muscularis propria into percolic fat lymphovascular perineural and extramural large vein invasion present 521 lymph nodes + location of known metastases lymph nodestumor gradestage pt3n2a	Colon Adenocarcinoma
esophageal adenocarcinoma	ESOPHAGEAL ADENOCARCINOMA
small cell sarcoma	Small Cell Sarcoma
adenocarcinoma - rectum location of known metastases liver	RECTAL ADENOCARCINOMA
melanoma recurrent disease primary sitelocation of known metastases lymph node	CUTANEOUS MELANOMA
melanoma final pathology dx confirmed tumor gradestage stage iiiclocation of known metastases lymph node	CUTANEOUS MELANOMA
nsclc (caucasian, epidermoid subtype)	Lung Non-Small Cell Carcinoma
cholangiocarcinoma	CHOLANGIOCARCINOMA
lymphoma (dlbcl)	Diffuse Large B-Cell Lymphoma
gingival squamous cell carcinoma	Gingival Squamous Cell Carcinoma
h n squamous cell car, nos tumor gradestage stage ivarecurrent disease at primary site	Head and Neck Squamous Cell Carcinoma
carcinosarcoma of the uterus	Uterine Carcinosarcoma
medulloblastoma 4	MEDULLOBLASTOMA
lobular carcinoma in situ; nos	Lobular Breast Carcinoma In Situ
lmm melanoma	Lentigo Maligna Melanoma
rare cancers sezary syndrome	Sezary Syndrome
braf mutated gist	Gastrointestinal Stromal Tumor
cecum  adenocarcinoma	Cecum Adenocarcinoma
adenocarcinoma	BLADDER ADENOCARCINOMA
bac	Lung Adenocarcinoma In Situ
stomach cancer other	Gastric Cancer
adrenocortical carcinoma	Adrenal Cortical Carcinoma
invasive breast carcinoma	Invasive Breast Carcinoma
invasive breast carcinoma tnbc ductal tumor gradestage t2n1a	INVASIVE DUCTAL CARCINOMA NOT OTHERWISE SPECIFIED
squamous cell lung carcinoma patient was registered as nsclc nos the pdx outgrowth was of a squamous cell lung carcinoma the diagnosis was reclassified	LUNG SQUAMOUS CELL CARCINOMA
carcinoma	Pancreatic Carcinoma
oligodendroglioma	Anaplastic Oligodendroglioma
liposarcoma myxoid  final pathology dx confirmed  abdominal tumor invasive to abdominis rectus muscleprior malignancy hodgkins lymphoma prior treatment for hodgkins lymphoma 011981 undefined chemoradiation, treatment information limited tumor gradestage fnclcc grade 1	Myxoid Liposarcoma
rhabdomyosarcoma	Rhabdomyosarcoma
adenocarcinoma - pancreas tumor stagegrade t3n1m1	PANCREATIC ADENOCARCINOMA
adult t acute lymphoblastic leukemia	T ACUTE LYMPHOBLASTIC LEUKEMIA
leiomyosarcoma	Uterine Corpus Leiomyosarcoma
malig. periph. nerve sheath tum.	Malignant Peripheral Nerve Sheath Tumor
gastric cancer, nos	Gastric Cancer
lung adenocarcinoma	LUNG ADENOCARCINOMA
metastasis lung	Brain Cancer
adenocarcinoma - colon history of prostate cancer diagnosed 2006 recurrent diseaselocation of known metastases liver	COLON ADENOCARCINOMA
invasive adenocarcinoma	Lung Adenocarcinoma
liver cancer	Hepatobiliary Cancer
ovarian cancer	Ovarian Cancer
sezary	Sezary Syndrome
leiomyosarcoma - not uterine patient registered as liposarcoma pdx outgrowth was soft tissue tumor most consistent with leiomyosarcoma the diagnosis was reclassified location of primary tumor retroperitoneum	LEIOMYOSARCOMA
pyriform fossa squamous cell carcinoma	Pyriform Fossa Squamous Cell Carcinoma
non-rhabdo soft tissue sarcoma pleomorphic sarcoma patient was registered as non-rhabdo soft tissue sarcoma high grade with spindle cell features pdx pathology review with ihc revised to undifferentiated pleomorphic sarcoma tumor stagegrade undifferentiated recurrent disease primary site	UNDIFFERENTIATED PLEOMORPHIC SARCOMA
ovarian cancer carcinosarcoma (malignant mixed mullerian tumor)	Ovarian Carcinosarcoma
lung mixed small cell and squamous cell carcinoma	Lung Cancer
angioimmunoblastic t-cell lymphoma	ANGIOIMMUNOBLASTIC T-CELL LYMPHOMA
unknown cancer	CANCER
fusion-positive rhabdomyosarcoma	Fusion-Positive Rhabdomyosarcoma
acute myeloid leukemia not otherwise specified	Acute Myeloid Leukemia Not Otherwise Specified
invasive ductal carcinoma	Invasive Breast Carcinoma of No Special Type
plasma cell myeloma	PLASMA CELL MYELOMA
adenocarcinoma - stomach	Gastric Adenocarcinoma
h n squamous cell car nos keratinizing	KERATINIZING HEAD AND NECK SQUAMOUS CELL CARCINOMA
adenocarcinoma - esophagus	Esophageal Adenocarcinoma
intraductal micropapillary carcinoma	Intraductal Micropapillary Breast Carcinoma
cervical small cell carcinoma	Cervical Small Cell Neuroendocrine Carcinoma
glioblastoma gliosarcoma	Gliosarcoma
clear cell sarcoma	CHILDHOOD SOFT TISSUE SARCOMA
lung adenocarcinoma prior history of lymphoma	LUNG ADENOCARCINOMA
burkitt's lymphoma	BURKITT LYMPHOMA
lung adenocarcinoma	Lung Adenocarcinoma
head and neck cancer: paranasal sinuses and nasal cavity squamous cell carcinoma (nos)	Sinonasal Squamous Cell Carcinoma
adenocarcinoma - colon invasive, mucinous tumor gradestage t3n0m0 stage iia, moderately differentiated	Colon Mucinous Adenocarcinoma
esophageal adenocarcinoma	Esophageal Adenocarcinoma
rare cancers undifferentiated sarcoma	Bone Sarcoma
urothelialbladder cancer nos high grade papillary location of known metastases kidney bowel and bladder	Urinary System Cancer
pancreatic cancer adenocarcinoma ductal type	Pancreatic Ductal Adenocarcinoma
non-acral cutaneous melanoma	Cutaneous Melanoma
b acute lymphoblastic leukemia with t(v;11q23.3); kmt2a rearranged	B Acute Lymphoblastic Leukemia with t(v;11q23.3); KMT2A Rearranged
ovarian cancer mucinous carcinoma	Ovarian Mucinous Adenocarcinoma
head and neck cancer	Tongue Cancer
salivary gland cancer adenocarcinoma	Salivary Gland Adenocarcinoma
metastasis breast	Breast Cancer
chronic myelogenous leukemia	Chronic Myelogenous Leukemia BCR-ABL1 Positive
gallbladder carcinoma	Gallbladder Carcinoma
undifferentiated lung carcinoma with a large cell neuroendocrine carcinoma	Lung Large Cell Neuroendocrine Carcinoma
adenocarcinoma - pancreas moderately differentiated mucinous final pathology dx confirmed with extensive perineural invasion less than 1 of liver volume involved in metastasis tumor gradestage grade iv aypt4 aypn1 aypm1 ajcc pathologic staginglocation of known metastases liver diaphragm mesentery omentum adrenal glands bilateral lungs rectal soft tissue and muscularis propria appendix serosal soft tissue of the esophagus lymph nodes regional and distant	PANCREATIC ADENOCARCINOMA
ampulla of vater cancer adenocarcinoma	Ampulla of Vater Adenocarcinoma
primary cutaneous cd30-positive t-cell lymphoproliferative disorder	Primary Cutaneous CD30-Positive T-Cell Lymphoproliferative Disorder
invasive lobular breast carcinoma	Invasive Breast Lobular Carcinoma Solid Variant
female reprod. system cancer nos	Female Reproductive System cancer
adenocarcinoma, nos location of primary tumor unknown	ADENOCARCINOMA
esophageal cancer esophagus adenocarcinoma (nos)	Esophageal Adenocarcinoma
squamous cell lung carcinoma	Lung Squamous Cell Carcinoma
urothelialbladder cancer nos  papillary tumor gradestage high grade	Bladder Papillary Urothelial Neoplasm
liporal cavity squam cell car invasive moderately differentiated	Lip and Oral Cavity Squamous Cell Carcinoma
nsclc	Lung Non-Small Cell Carcinoma
nasal type extranodal nk/t-cell lymphoma	Nasal Type Extranodal NK/T-Cell Lymphoma
kidney cancer renal medullary carcinoma	Kidney Medullary Carcinoma
squamous cell	Lung Squamous Cell Carcinoma
transitional cell car - uroth recurrent disease	Transitional Cell Carcinoma
neuroendocrine carcinoma	Neuroendocrine Carcinoma
melanoma tumor stagegrade stage iiic t2n3cmolocation of known metastases right axilla	CUTANEOUS MELANOMA
neuroendocrine cancer nos poorly differentiated carcinoma final pathology neuroendocrine nos favoring carcinoma of gi origin location of known metastases liver lymph nodes	Neuroendocrine Neoplasm
colon cancer (caucasian, europe)	Colon Cancer
hilar cholangiocarcinoma	Hilar Cholangiocarcinoma
colon mucinous adenocarcinoma	Colon Mucinous Adenocarcinoma
epithelioid leiomyosarcoma	Epithelioid Leiomyosarcoma
pancreatic cancer other	Pancreatic Carcinoma
squamous cell lung carcinoma invasive extensive history of cancer and cancer-related mortality among primary relativesfinal pathology dx confirmed tumor stagegrademoderately differentiated	LUNG SQUAMOUS CELL CARCINOMA
central nervous system cancer	Central Nervous System Cancer
head and neck cancer	Laryngeal Cancer
melanoma final pathology dx confirmed with involvement of the subcutaneous tissue and extension to the deep surgical marginstumor stagegrade pt4nxm0location of metastases buttock lung	CUTANEOUS MELANOMA
gastric cancer nos	Gastric Cancer
malignant ovarian brenner tumor	Malignant Ovarian Brenner Tumor
splenic marginal zone b-cell lymphoma with villous lymphocytes	Splenic Marginal Zone Lymphoma
gastric cancer	Gastric Cancer
t-cell-prolymphocytic leukemia	T-CELL PROLYMPHOCYTIC LEUKEMIA
squamous cell thyroid gland carcinoma	Thyroid Gland Squamous Cell Carcinoma
sarcoma	SARCOMA
liporal cavity squam cell car final pathology 635 lymph nodes + for lymph-vascular and perineural invasion tumor gradestage pt4an2b	Lip and Oral Cavity Squamous Cell Carcinoma
adenocarcinoma - colon adenocarcinoma ho crcfinal pathology confirmed dx metastatic colon adenocarcinoma location of known metastases liver	Colon Adenocarcinoma
colon tubular adenoma	Colon Tubular Adenoma
melanoma	MELANOMA
gestational choriocarcinoma	Gestational Choriocarcinoma
acinar cell carcinoma	Pancreatic Acinar Cell Carcinoma
adenosquamous carcinoma	EXTRAHEPATIC BILE DUCT ADENOSQUAMOUS CARCINOMA
parotid gland mucoepidermoid carcinoma	Parotid Gland Mucoepidermoid Carcinoma
rhabdomyosarcoma	Childhood Rhabdomyosarcoma
adenocarcinoma - colon  focally invasive  final pathology confirms dx with moderate tumor budding invasion through the muscularis propria into pericolonic tissue suspicious for lymphovascular and perineural invasion tumor gradestage low-grade	COLON ADENOCARCINOMA
nsclc (caucasian, epidermoid subtype)	LUNG NON-SMALL CELL CARCINOMA
leiomyosarcoma - uterus location of known metastases lung	Leiomyosarcoma
endometriod adenocarcinoma	ENDOMETRIOID ADENOCARCINOMA
lung cancer acinar adenocarcinoma	Lung Acinar Adenocarcinoma
alveolar ridge squamous cell carcinoma	Alveolar Ridge Squamous Cell Carcinoma
epidermal carcinoma	SKIN CARCINOMA
colorectal cancer adenocarcinoma	Colorectal Adenocarcinoma
renal cell carcinoma nos papillary and clear cell features location of known metastases adrenal gland	Clear Cell Renal Cell Carcinoma
rcc clear cell adenocarcinoma tumor gradestage fuhrman nuclear grade 4	Clear Cell Renal Cell Carcinoma
squamous cell lung carcinoma moderately differentiated invasive  final pathology dx confirmed lymphovascular invasion present 711 hilar lymph nodes positive for metastatic tumor location of known metastases lymph nodes	LUNG SQUAMOUS CELL CARCINOMA
cholangiocarcinoma	Cholangiocarcinoma
ductal	Ductal Breast Carcinoma
not collected	Ovarian Neoplasm
inflammatory breast cancer	inflammatory breast carcinoma
urothelialbladder cancer nos  papillary tumor gradestage high grade	BLADDER PAPILLARY UROTHELIAL NEOPLASM
invasive ductal carcinoma	Invasive Ductal Carcinoma Not Otherwise Specified
adenocarcinoma	Endometrial Adenocarcinoma
adenosquamous carcinoma	LUNG ADENOSQUAMOUS CARCINOMA
bone osteosarcoma	Bone Osteosarcoma
sacromatoid carcinoma	Lung Sarcomatoid Carcinoma
anaplastic large cell lymphoma alk-negative	Anaplastic Large Cell Lymphoma ALK-Negative
malignant mesothelioma	MALIGNANT MESOTHELIOMA
rcc clear cell adenocarcinoma	Clear Cell Renal Cell Carcinoma
head and neck cancer	Oral Cavity Cancer
lung cancer invasive mucinous adenocarcinoma with signet ring features	Invasive Lung Mucinous Adenocarcinoma
acute biphenotypic leukemia	ACUTE BIPHENOTYPIC LEUKEMIA
mantle cell lymphoma	MANTLE CELL LYMPHOMA
epithelioid cell type gastrointestinal stromal tumor	Malignant Epithelioid Cell Type Gastrointestinal Stromal Tumor
adenocarcinoma - pancreas final pathology dx confirmed with dense desmoplastic structure 40 of liver involved invasive through the muscularis propria of the colon pancreas findings of panin-1a patient with suspected lynch syndrome tumor gradestage grade iv,moderately differentiatedlocation of known metastases bilateral adrenal glands, diaphragm, colon, liver, carcinomatosis	PANCREATIC ADENOCARCINOMA
rhabdomyosarcoma nos adult type pleomorphic multifocal lymphovascular invasion tumor gradestage grade 3 location of known metastases lymph nodes	Adult Pleomorphic Rhabdomyosarcoma
rare cancers noninfiltrating intraductal papillary adenocarcinoma	Gallbladder Adenocarcinoma
pancreatic carcinoma - infiltrating ductal adenocarcinoma (idac) + intraductal papillary mucinous neoplasm (ipmn)	Pancreatic Intraductal Papillary-Mucinous Neoplasm with an Associated Invasive Carcinoma
squamous cell lung carcinoma poorly differentiated	Lung Squamous Cell Carcinoma
laryngeal squamous cell carcinoma	Laryngeal Squamous Cell Carcinoma
small cell carcinoma	Lung Non-Small Cell Carcinoma
pancreatic cancer (not islets)	Pancreatic Cancer
leukemia (aml)	Acute Myeloid Leukemia
breast carcinoma	Breast Carcinoma
b-cell precursor acute lymphoblastic leukemia	B ACUTE LYMPHOBLASTIC LEUKEMIA
sarcoma	Uterine Corpus Sarcoma
t-cell non-hodgkin's lymphoma	B-Cell Non-Hodgkin Lymphoma
non-rhabdo soft tissue sarcoma pleomorphic undifferentiated dermal	UNDIFFERENTIATED PLEOMORPHIC SARCOMA
glioblastoma multiforme	Brain Stem Glioblastoma
wilms	Kidney Wilms Tumor
leukemia	LEUKEMIA
fusion positive rhabdomyosarcoma	Fusion-Positive Rhabdomyosarcoma
liporal cavity squam cell car location of known metastasis lung	LIP AND ORAL CAVITY SQUAMOUS CELL CARCINOMA
hepatocellular carcinoma	HEPATOCELLULAR CARCINOMA
pleuramesothelioma	Pleural Mesothelioma
ovarian undifferentiated carcinoma	Ovarian Undifferentiated Carcinoma
adenocarcinoma - rectum	Rectal Adenocarcinoma
ovarian cancer nos	OVARIAN CANCER
adenocarcinoma - rectum location of known metastases lungsrecurrent disease primary site	Rectal Adenocarcinoma
bladder cancer	BLADDER CANCER
malignant teratoma	Testicular Teratoma with Somatic-Type Malignancy
invasive breast carcinoma ho breast cancer right diagnosed in 2008 with recurrence in 2013 - treated w radiation chemotherapy and hormone therapy metastasis from right breast or new primary - limited information available	Invasive Breast Carcinoma
glioblastoma multiforme high-grade astrocytoma recurrent disease	Glioblastoma
adenocarcinoma - colon mucinous and signet-ring features final pathology dx confirmed high-grade with mucinous and signet-ring features and prominent tumor budding tumor arises in ascending colon and invades the subserosa and lympho-vascular space extramural venous and perineural invasion identified 1+ lymph node mesenteric  msi-hightumor gradestage high-grade pt3n1am1blocation of known metastasis lymph nodes	COLON ADENOCARCINOMA
small cell carcinoma	Bladder Small Cell Carcinoma
breast lobular carcinoma	Lobular Breast Carcinoma
rare cancers atypical carcinoid tumor	Small Intestinal Neuroendocrine Tumor
undifferentiated gallbladder carcinoma	GALLBLADDER CARCINOMA
rhabdoid tumor	RHABDOID TUMOR
glioma, idh-mutant	Malignant Brain Glioma
alveolar soft part sarcoma	Soft Tissue Sarcoma
rectal adenocarcinoma	Rectal Adenocarcinoma
papillary renal cell carcinoma	PAPILLARY RENAL CELL CARCINOMA
adenocarcinoma	Pancreatic Adenocarcinoma
prostate cancer	PROSTATE CANCER
non-rhabdo soft tissue sarcoma myxofibrosarcoma with epithelioid features tumor gradestage fnclcc grade 3 of 3 high grade	MYXOFIBROSARCOMA
adenocarcinoma - stomach adenocarcinoma - intestinal type tumor stagegrade moderately differentiated	GASTRIC ADENOCARCINOMA
vulvar squamous cell carcinoma	Vulvar Squamous Cell Carcinoma
mucinous adenocarcinoma of the colon, per path report	COLON MUCINOUS ADENOCARCINOMA
papillary serous adenocarcinoma	Ovarian Serous Surface Papillary Adenocarcinoma
nodular; ssm melanoma	NODULAR MELANOMA
pleural epithelioid mesothelioma	PLEURAL EPITHELIOID MESOTHELIOMA
small cell car extrapulmonary colon origin patient was registered as adenocarcinoma - colon invasion through the muscularis propria present patient was registered as adenocarcinoma - colon the pdx pathology confirms that the cells that grew out were from a small cell neuroendocrine carcinoma of the colon the diagnosis was reclassified	COLON SMALL CELL NEUROENDOCRINE CARCINOMA
fibrosarcoma - not infantile  myxofibrosarcoma final pathology dx confirmed mitotic activity up to 7 per 10 hpf no tumor necrosis identified recurrent disease primary site multifocal loco-regional recurrence of left buttockfnclcc grade 13 low grade	MYXOFIBROSARCOMA
leukemia (aml)	Leukemia
epstein-barr virus-related burkitt s lymphoma	EBV_and_Related Burkitt Lymphoma
squamous cell lung carcinoma poorly differientiated	LUNG SQUAMOUS CELL CARCINOMA
anaplastic astrocytoma nos	ANAPLASTIC ASTROCYTOMA
liver cancer (caucasian cholangiocarcinoma)	Cholangiocarcinoma
ad	Lung Adenocarcinoma
gastric adenocarcinoma	Gastric Adenocarcinoma
endometrial carcinoma	ENDOMETRIAL CARCINOMA
adenocarcinoma - colon adenocarcinoma  ho crcfinal pathology confirmed dx metastatic colon adenocarcinoma location of known metastases liver	COLON ADENOCARCINOMA
vaginal cancer, nos	Vaginal cancer
liporal cavity squam cell car invasive ho lichen planus treated with oral steroid wash and extensive resection multiple partial glossectomies 2008-2015 and most recently neck dissection lymph node positive scc confirmed in 215 nodes in oral cavity and 115 from neck dissectionhpv negative recurrent disease	Lip and Oral Cavity Squamous Cell Carcinoma
ovarian cancer nos	Ovarian Cancer
lung carcinoid tumor	Lung Carcinoid Tumor
uterine cancer nos clear cell carcinoma	Uterine Cancer
adenocarcinoma - colon mucinous ho testicular nonseminomatous germ cell tumor melanoma surgical resection only keratinizing head and neck squamous cell carcinoma of tonsil - metastatic, primary site not provided tumor gradestage pt3 pn1b mx	Colon Mucinous Adenocarcinoma
lymphoma	Non-Hodgkin Lymphoma
squamous cell carcinoma - skin location of known metastasis parotid gland	Skin Squamous Cell Carcinoma
melanoma est diagnosis date from first prior therapy	Cutaneous Melanoma
adenocarcinoma - rectum invasive moderately differentiated final pathology dx confirmed lymphovascular space and perineural invasion are present three tumor deposits identified in pericolic fat 2 of 16 lymph nodes positive for tumor location of known metastases pericolic fat lymph nodes	Rectal Adenocarcinoma
retinoblastoma	CHILDHOOD INTRAOCULAR RETINOBLASTOMA
rare cancers extrahepatic cholangiocarcinoma	Extrahepatic Bile Duct Carcinoma
lung adenocarcnoma mucinous	LUNG ADENOCARCINOMA
lung adenocarcinoma low grade raceethn whitenon-hispanic dxleft upper lobe lung nodule nsclc well differentiated adenocarcinoma t1n0 chemonone rxcompleted sbrt to a dose of 50 gy in five fractions for a t1n0 adenocarcinoma involving the right upper lobe 9 mos _after_ sx last fu14 mos after sx-clinically stable past med hxcopd gerd hiatal hernia cancer-squamous cell ca of vulva basal cell of face shortness of breath asthma past surg hxlaser tx of vulval basal cellsocial hx alcohol-yes ocassional owns pest control store fam hxmother-multiple myeloma sister- basal cell cancer grandmother and two aunts- breast cancer  tumor gradestage t1n0	LUNG ADENOCARCINOMA
diffuse large b-cell lymphoma	Diffuse Large B-Cell Lymphoma
renal cancer (caucasian)	KIDNEY CANCER
acral cutaneous melanoma	Acral Lentiginous Melanoma
invasive breast carcinoma ductal, tnbc tumor gradestage ct2n2	INVASIVE DUCTAL CARCINOMA NOT OTHERWISE SPECIFIED
ovarian mixed germ cell tumor	Ovarian Mixed Germ Cell Tumor
t-cell lymphoblastic leukemia	T LYMPHOBLASTIC LEUKEMIA/LYMPHOMA
adenocarcinoma - small intest.	Small Intestinal Adenocarcinoma
colon carcinoma	Colon Carcinoma
acute myeloid leukemia with inv(3) (q21.3;q26.2); gata2 mecom	Acute Myeloid Leukemia with inv(3) (q21.3;q26.2); GATA2 MECOM
invasive adenocarcinoma	PANCREATIC ADENOCARCINOMA
acute myeloid leukemia with variant mll translocations	Acute Myeloid Leukemia with Variant MLL Translocations
pancreatic acinar cell carcinoma with neuroendocrine differentiation	Mixed Acinar-Neuroendocrine Carcinoma of the Pancreas
clear cell sarcoma	Childhood Soft Tissue Sarcoma
anaplastic oligodendroglioma nos 3	ANAPLASTIC OLIGODENDROGLIOMA NOT OTHERWISE SPECIFIED
adenocarcinoma - colon ho melanoma ctep sdc code 10028566 tumor gradestage pt4an1bmx, moderately differentiated	COLON ADENOCARCINOMA
clear cell sarcoma	Clear Cell Sarcoma of Soft Tissue
adenocarcinoma - colon history of ductal carcinoma in situ of the breast	COLON ADENOCARCINOMA
uveal melanoma	Uveal Melanoma
adenocarcinoma	Gastric Adenocarcinoma
ovarian serous cystadenocarcinoma	Ovarian Serous Cystadenocarcinoma
synovial sarcoma	Synovial Sarcoma
glioblastoma idh wildtype 4	Glioblastoma IDH-Wildtype
other tubulovillous adenoma	Colon Cancer
pancreatic cancer infiltrating ductal carcinoma	Pancreatic Ductal Adenocarcinoma
thyroid gland anaplastic carcinoma	Thyroid Gland Anaplastic Carcinoma
myelodysplastic syndrome with multilineage dysplasia	Myelodysplastic Syndrome with Multilineage Dysplasia
gastric fundus carcinoma	Gastric Fundus Carcinoma
undifferentiated pleomorphic sarcoma	Undifferentiated Pleomorphic Sarcoma
squamous cell lung carcinoma location of known metastases brain	LUNG SQUAMOUS CELL CARCINOMA
peripheral t-cell lymphoma not other specified	PERIPHERAL T-CELL LYMPHOMA NOT OTHERWISE SPECIFIED
adrenal neuroblastoma	Adrenal Gland Neuroblastoma
ewing sarcomaperipheral pnet final pathology dx confirmed with 50 necrosisprimary tumor location vulva tumor gradestage high grade or ungraded sarcoma fnclcc pt2	Ewing Sarcoma
renal cell carcinoma	RENAL CELL CARCINOMA
sarcoma leiomyosarcoma	Leiomyosarcoma
glioblastoma multiforme neural	GLIOBLASTOMA
chronic myelogenous leukemia bcr-abl1 positive	Chronic Myelogenous Leukemia BCR-ABL1 Positive
metastasis yolk sac tumor	Testicular Yolk Sac Tumor
bladder carcinoma	BLADDER CARCINOMA
lung squamous cell carcinoma basaloid	Lung Squamous Cell Carcinoma
adenocarcinoma - colon mucinous tumor stagegrade moderately differentiated	COLON MUCINOUS ADENOCARCINOMA
adenocarcinoma, nos	Adenocarcinoma of Unknown Primary
colorectal cancer mucinous adenocarcinoma	Colorectal Mucinous Adenocarcinoma
neuroblastoma	CHILDHOOD NEUROBLASTOMA
non-rhabdo soft tissue sarcoma tumor gradestage fnclcc grade 3	SOFT TISSUE SARCOMA
t-cell large granular lymphocyte leukemia	T-Cell Large Granular Lymphocyte Leukemia
b-cell lymphoma unclassifiable with features intermediate between diffuse large b-cell lymphoma and classic hodgkin lymphoma	B-Cell Lymphoma Unclassifiable with Features Intermediate between Diffuse Large B-Cell Lymphoma and Classic Hodgkin Lymphoma
astrocytoma	BRAIN ASTROCYTOMA
glioblastoma	BRAIN GLIOBLASTOMA
adenocarcinoma - cervix	Cervical Adenocarcinoma
lung adenocarcinoma poorly differentiated tumor gradestage pt2n0m0 grade 3 stage ib ajccprimary site of disease lung left upper lobe	Lung Adenocarcinoma
salivary gland cancer	Salivary Gland Cancer
malignant pleural mesothelioma	Pleural Malignant Mesothelioma
carcinosarcoma of the uterus final pathology dx confirmed with heterologous elements site of tumor origin unclear  incidental finding serous tubal intraepithelial carcinoma with focal serous carcinoma of the right fallopian tube may be independent finding or a focus of tumor colonization tumor gradestage pt3alocation of known metastases pelvic soft tissue parametrial soft tissue with lymphovascular invasion left fallopianovary soft tissue pericolic fat of the rectum	UTERINE CARCINOSARCOMA
head and neck cancer: lip and oral cavity squamous cell carcinoma, conventional	Lip and Oral Cavity Squamous Cell Carcinoma
head and neck cancer	Head and Neck Cancer
basaloid squamous cell carcinoma	Basaloid Squamous Cell Carcinoma
vaginal cancer nos invasive poorly differentiated non-keratinizing squamous cell carcinoma  final path dx confirmed + lymphovascular invasion at primary and metastatic locations prior ho endometrioid endometrial adenocarcinoma surgery only metastatic location suburethral lymph nodes	VAGINAL SQUAMOUS CELL CARCINOMA NOT OTHERWISE SPECIFIED
hereditary thyroid gland medullary carcinoma	Hereditary Thyroid Gland Medullary Carcinoma
erythroleukemia	ERYTHROLEUKEMIA
soft tissue neoplasm nos pleomorphic high grade	Soft Tissue Cancer
maxillary sinus squamous cell carcinoma	Maxillary Sinus Squamous Cell Carcinoma
squamous cell carcinoma	Lung Squamous Cell Carcinoma
laryngeal squamous cell carcinoma scc of the glottic larynx sp radiationscc of the glottic larynx	LARYNGEAL SQUAMOUS CELL CARCINOMA
lung mucoepidermoid carcinoma	LUNG MUCOEPIDERMOID CARCINOMA
invasive bladder transitional cell carcinoma	Infiltrating Bladder Urothelial Carcinoma
atypical teratoid/rhabdoid tumor	Atypical Teratoid/Rhabdoid Tumor
desmoplastic small round cell tumor	CHILDHOOD DESMOPLASTIC SMALL ROUND CELL TUMOR
alveolar rhabdomyosarcoma	ALVEOLAR RHABDOMYOSARCOMA
urothelialbladder cancer, nos invasive papillary of the bladder recurrent disease primary siteinvasive into muscularis propriatumor stagegrade high-grade	Bladder Papillary Urothelial Carcinoma
giant cell lung carcinoma	Lung Giant Cell Carcinoma
adenocarcinoma - pancreas ho breast cancer tumor gradestage pt2n1m1location of known metastasis liver	Pancreatic Adenocarcinoma
adenocarcinoma - colon prior malignancy basal cell cancer ctep sdc code 10004146 treatment history available tumor stagegrade ct4cn0cm0 stage 2clocation of known metastases bladder	COLON ADENOCARCINOMA
ovarian mesodermal adenosarcoma	Ovarian Adenosarcoma
invasive breast carcinoma ductal ihc pr+ er- her2- tumor gradestage t2n1a	INVASIVE DUCTAL CARCINOMA NOT OTHERWISE SPECIFIED
small cell carcinoma	Esophageal Small Cell Neuroendocrine Carcinoma
mature t-cell and nk-cell lymphoma	Mature T-Cell and NK-Cell Non-Hodgkin Lymphoma
melanoma final pathology dx confirmed location of known metastases axillary lymph nodetumor gradestage pt0n1m0	CUTANEOUS MELANOMA
adenocarcinoma - pancreas moderately differentiated final pathology resection of the pancreatic head - dx confirmed ductal and panin-1	Pancreatic Adenocarcinoma
melanoma	cutaneous melanoma
pancreatic carcinoma	Pancreatic Carcinoma
metastasis pancreas	PANCREATIC CANCER
chronic myelogenous leukemia	MYELOID LEUKEMIA
hepatoblastoma	HEPATOBLASTOMA
osteosarcoma	Bone Osteosarcoma
non-rhabdo soft tissue sarcoma pleomorphic with focal myxoid features tumor stagegrade high-grade	UNDIFFERENTIATED PLEOMORPHIC SARCOMA
gastric cancer	GASTRIC CANCER
burkitt lymphoma	Burkitt Lymphoma
cns germinoma	Central Nervous System Germinoma
lung adenosquamous carcinoma	LUNG ADENOSQUAMOUS CARCINOMA
endometrial cancer endometrioid carcinoma with secretory differentiation	Endometrial Carcinoma
gastrointestinal stromal tumor	Gastrointestinal Stromal Tumor
melanoma	Ocular Melanoma
soft tissue neoplasm, nos	Soft Tissue Neoplasm
liporal cavity squam cell car moderately-differentiated final pathology tongue and floor of mouth en bloc resection dx confirmed	ORAL CAVITY SQUAMOUS CELL CARCINOMA
pharyngeal squam cell carcinoma history of chewing tobacco use x 1 year, discontinued 20yrs ago tumor stagegrade t3n2blocation of primary tumor tonsil	LARYNGEAL SQUAMOUS CELL CARCINOMA
squamous cell carcinoma - skin	Skin Squamous Cell Carcinoma
melanoma	Melanoma
rare cancers epithelioid sarcoma	Epithelioid Sarcoma
pleural biphasic mesothelioma	PLEURAL BIPHASIC MESOTHELIOMA
cancer	Bladder Cancer
b acute lymphoblastic leukemia	B ACUTE LYMPHOBLASTIC LEUKEMIA
ovarian epithelial cancer location of known metastasis neck	Ovarian Carcinoma
colorectal cancer undifferentiated carcinoma	Colon Undifferentiated Carcinoma
liporal cavity squam cell car final pathology dx confirmed positive lymphovascular and perineural invasion 3 of 71 level 2-4 nodes positive 2 of 10 level 1 nodes positive extra-nodal extension identified recurrent disease primary sitelocation of known metastases tongue, bilateral alveolar gingiva, floor of mouth, lingual nervetumor stagegrade moderately differentiated	Lip and Oral Cavity Squamous Cell Carcinoma
bronchiolo-alveolar lung carcinoma	Lung Carcinoma
malignant fibrous histiocytoma undifferentiated pleomorphic recurrent disease at primary site soft tissue mass in thighhigh-grade	Undifferentiated Pleomorphic Sarcoma
h n squamous cell car, nos keratinizing	Head and Neck Keratinizing Squamous Cell Carcinoma
low grade serous ovarian cancer	Low Grade Ovarian Serous Adenocarcinoma
invasive breast carcinoma ductal, tnbc	Triple-Negative Breast Carcinoma
malignant fibrous histiocytoma	Undifferentiated Pleomorphic Sarcoma
lung large cell neuroendocrine carcinoma	Lung Large Cell Neuroendocrine Carcinoma
meningioma	Meningioma
endometrioid endomet adenocar final pathology dx confirmed arising in the endometrium with invasion to myometrium tumor gradestage figo grade 2location of known metastases bilateral ovaries peritoneum posterior cul de sac small bowel nodule omentum gastric nodule	Endometrial Endometrioid Adenocarcinoma
unknown	Digestive System Cancer
melanoma location of known metastases adrenals, axillary lymph nodeslocation of primary tumor back skin	Cutaneous Melanoma
neuroblastoma	Mediastinal Neuroblastoma
salivary gland cancer acinic cell carcinoma location of known metastases pleura	Salivary Gland Acinic Cell Carcinoma
cns ewing sarcoma family tumor with cic alteration	EWING SARCOMA
b-cell prolymphocytic leukemia	B-Cell Prolymphocytic Leukemia
tonsil cancer	Tonsillar Cancer
ovarian epithelial cancer adenocarcinoma, papillary component	OVARIAN CARCINOMA
centroblastic lymphoma	Centroblastic Lymphoma
ovarian small cell carcinoma, hypercalcemic type	Ovarian Small Cell Carcinoma Hypercalcemic Type
stomach cancer tubular (intestinal) adenocarcinoma	Gastric Adenocarcinoma
not specified	Pancreatic Cancer
pharyngeal squam cell carcinoma final path poorly differentiated squamous cell carcinoma with lymphovascular invasion	Pharyngeal Squamous Cell Carcinoma
her2-e	Breast Cancer
angioimmunoblastic t-cell lymphoma	Angioimmunoblastic T-Cell Lymphoma
not specified	Colon Cancer
endometrioid endomet. adenocar.	Endometrial Endometrioid Adenocarcinoma
ewing sarcomaperipheral pnet recurrent disease	Ewing Sarcoma/Peripheral Primitive Neuroectodermal Tumor of Bone
adenocarcinoma - colon adrenal mass was unresponsive to study agents all other sites of disease lung and liver initially responded location of known metastases liver lung adrenal gland bone	Colon Adenocarcinoma
not specified	OVARIAN CANCER
squamous cell lung carcinoma tumor stagegrade poorly differentiated	LUNG SQUAMOUS CELL CARCINOMA
liporal cavity squam cell car final pathology moderately differentiated scc confirmed with greater than half ln positive location of know metastases lymph nodestumor stagegrade moderately differentiated	LIP AND ORAL CAVITY SQUAMOUS CELL CARCINOMA
colon signet ring adenocarcinoma	Colon Signet Ring Cell Adenocarcinoma
malig periph nerve sheath tum recurrence at primary sitetumor gradestage rt2bn0m0 grade 4	MALIGNANT PERIPHERAL NERVE SHEATH TUMOR
adenocarcinoma - pancreas  wmucinous features final pathology dx confirmed with 5-10 of liver involved by metastasisconcurrent dx papillary rcc pax8+, ck7+, cd117-, grade 1 and clear cell rcc pax8+, ck7-, cd117-prior ho basel cell carcinoma and bladder cancer tumor stagegrade grade iv, moderately differentiatedlocation of known metastases lung multifocal, liver, carcinomatosis, abdominal lymph nodes, diaphragm	PANCREATIC ADENOCARCINOMA
mucoepidermoid carcinoma	Salivary Gland Mucoepidermoid Carcinoma
metastasis colon	COLON CANCER
metastasis ovary	OVARIAN CANCER
adenosquamous lung carcinoma	LUNG ADENOSQUAMOUS CARCINOMA
adenocarcinoma - colon concurrent malignancy gist tumor gradestage t2 n0 m0 primary tumor location sigmoid colontumor stagegrade t3 n0 stage iia	COLON ADENOCARCINOMA
head and neck squamous cell carcinoma	Head and Neck Squamous Cell Carcinoma
pancreatic cancer not islets ductal adenocarcinoma poorly differentiated final pathology dx confirmed with microscopic tumor extension invading into duodenal wall and retroperitoneal soft tissue tumor gradestage grade 3	PANCREATIC DUCTAL ADENOCARCINOMA
squamous cell lung carcinoma invasive final pathology dx confirmed +vascular invasion, 14 hilar lymph nodes + for carcinoma tumor gradestage pt2a pn1, moderately differentiated	LUNG SQUAMOUS CELL CARCINOMA
gastric cancer nos exophytic adenocarcinoma	Gastric adenocarcinoma
lung cancer non-small cell carcinoma	Lung Non-Small Cell Carcinoma
non small cell carcinoma	LUNG NON-SMALL CELL CARCINOMA
synovial sarcoma	Childhood Synovial Sarcoma
adrenal cortical carcinoma	Adrenal Cortex Carcinoma
colon adenocarcinoma	COLORECTAL CARCINOMA
ipmn, invasive mucinous noncystic adenocarcinoma	Pancreatic Colloid Carcinoma
endometrioid endomet adenocar secretory and clear cell features final pathology dx confirmed in bilateral ovaries with lymphovascular invasion tumor gradestage figo grade 1location of known metastases ovary large bowel	Endometrial Endometrioid Adenocarcinoma
cervical carcinoma	Cervical Carcinosarcoma
glioblastoma multiforme astrocytoma grade 4	Glioblastoma
liver cancer	Adult Liver Carcinoma
mucinous noncystic adenocarcinoma	Pancreatic Colloid Carcinoma
adult t-cell leukemia	ADULT T-CELL LEUKEMIA/LYMPHOMA
rare cancers non-hodgkin lymphoma	Non-Hodgkin Lymphoma
uterine cancer, nos invasive, clear cell carcinoma of the endometrium final pathology dx confirmed 18 of 28 pelvic and peri-aortic nodes positive for disease, extranodal extension present invasive through 100 of myometrium extensive lymphovascular invasion identified as well as extensive necrosis in the uterine portionfamily history of breast cancer and uterine leiomyosarcoma tumor gradestage pt3a pn2location of known metastases bilateral ovaries, lymph nodes	Uterine Cancer
metastatic adenocarcinoma	ENDOMETRIAL ADENOCARCINOMA
follicular thyroid carcinoma	THYROID GLAND FOLLICULAR CARCINOMA
adenocarcinoma - colon mucinous with signet ring features	COLON MUCINOUS ADENOCARCINOMA
high grade glioma iii	WHO Grade III Glioma
neuroendocrine tumor	Lung Neuroendocrine Neoplasm
mesothelioma	Malignant Mesothelioma
renal pelvis carcinoma	Renal Pelvis Carcinoma
primary peritoneal carcinoma	Primary Peritoneal Carcinoma
colon cancer (caucasian europe)	Colon Cancer
philadelphia chromosome negative like acute lymphoblastic leukemia	Acute Lymphoblastic Leukemia
medulloblastoma large cell/anaplastic medulloblastoma	Large Cell_and_Anaplastic Medulloblastoma
high grade serous carcinoma	Ovarian Serous Adenocarcinoma
breast cancer (her2-enriched)	BREAST CANCER
rare cancers squamous cell carcinoma	Skin Squamous Cell Carcinoma
high grade mixed epithelial type carcinoma serous carcinoma and clear cell carcinoma t1an0mx	Ovarian Carcinoma
endometrial cancer carcinosarcoma (malignant mixed mullerian tumor)	MALIGNANT MIXED MESODERMAL (MULLERIAN) TUMOR
urothelialbladder cancer nos invasive papillary of the bladder sarcomatoid features concurrent malignancy adenocarcinoma of the prostate ho childhood non-hodgkins lymphoma tumor gradestage high grade	Bladder Papillary Urothelial Carcinoma
anaplastic large cell lymphoma	Anaplastic Large Cell Lymphoma
lung squamous cell carcinoma (sqcc)	LUNG SQUAMOUS CELL CARCINOMA
invasive breast carcinoma tnbc mammary  concurrent malignancyurothelial tractbladder cancer nos diagnosed 32017 treated surgically	Invasive Breast Carcinoma
melanoma melanoma (nos)	Cutaneous Melanoma
h n squamous cell car, nos final pathology dx confirmed as metastatic scc with complete replacement of adjacent lymph node and direct extension into parotid gland primary site of origin indeterminateconcurrent malignancy squamous cell carcinoma - skin basal cell carcinoma location of known metastases parotid gland	Head and Neck Squamous Cell Carcinoma
adenocarcinoma	Duodenal Adenocarcinoma
neuroblastoma	Peripheral Neuroblastoma
carcinosarcoma of the uterus mixed malignant mullerian tumor  recurrent diseaselocation of metastases colon	UTERINE CARCINOSARCOMA
ad and bac	Adenocarcinoma
moderately diffentiated pancreatic ductal adenocarcinoma	Pancreatic Moderately Differentiated Ductal Adenocarcinoma
neuroblastoma	Adrenal Gland Neuroblastoma
colorectal cancer squamous cell carcinoma	Colon Squamous Cell Carcinoma
ovarian serous carcinoma	Ovarian Serous Adenocarcinoma
non-rhabdo soft tissue sarcoma spindle cell solitary fibrous tumor final pathology solitary fibrous tumor focally involving the surgical margin   recurrent disease	SPINDLE CELL SARCOMA
glioblastoma	Glioblastoma
adenocarcinoma - colon moderately differentiated final pathology dx confirmed low grade with mucinous features tumor invades to the interface of the muscularis propria and pericolonic tissue with very focal lymph-vascular space invasion identified tumor stagegrade pt3n0 ajcc 7th edition low grade	Colon Adenocarcinoma
head and neck cancer	HEAD AND NECK CANCER
epidermal carcinoma	Skin Carcinoma
adenocarcinoma - colon location of known metastases liver	COLON ADENOCARCINOMA
lymphoma cns	CENTRAL NERVOUS SYSTEM LYMPHOMA
pancreas adenocarcinoma	PANCREATIC ADENOCARCINOMA
poorly diffentiated pancreatic ductal adenocarcinoma	Pancreatic Poorly Differentiated Ductal Adenocarcinoma
lymphoma cns	Central Nervous System Lymphoma
endometrioid ovarian cancer	Malignant Ovarian Endometrioid Tumor
lung cancer adenocarcinoma (nos)	Lung Adenocarcinoma
metastasis lung	Lung Cancer
endometrioid endomet adenocar secretory and clear cell features final pathology dx confirmed in bilateral ovaries with lymphovascular invasion  tumor gradestage figo grade 1location of known metastases ovary large bowel	Endometrial Endometrioid Adenocarcinoma
synovial sarcoma final pathology dx confirmed, high grade with direct intracardiac extension of the tumor mass extensive lymphovascular invasion including pulmonary veins pre-op thoracentesis mitotic activity 23 mitoses10 hpfs tumor gradestage fnclcc grade of 3 of 3 pt2bn0, poorly differentiatedprimary cardiaclocation of known metastases lung	SYNOVIAL SARCOMA
adenocarcinoma - colon location of known metastases shoulder	Colon Adenocarcinoma
head and neck squamous cell carcinoma	Retromolar Trigone Squamous Cell Carcinoma
b acute lymphoblastic leukemia	B Acute Lymphoblastic Leukemia
nasopharyngeal carcinoma keratinizing squamous cell	NASOPHARYNGEAL CARCINOMA
glioblastoma idh mutant 4	Glioblastoma IDH-Mutant
sq	Lung Squamous Cell Carcinoma
urothelialbladder cancer nos squamous cell diagnosed in 1993 no further specific information available per site	Bladder Squamous Cell Carcinoma
astrocytoma	Brain Astrocytoma
invasive breast carcinoma ductal tnbc final pathology dx confirmed with high grade ductal carcinoma in situ with comedo necrosis +lymphovascular invasion  tumor gradestage elston-ellis grade 3 pt2	INVASIVE DUCTAL CARCINOMA NOT OTHERWISE SPECIFIED
mucinous adenocarcinoma	Appendix Mucinous Adenocarcinoma
pharyngeal squam cell carcinoma invasive poorly differentiated non- keratinizing final pathology dx confirmed extension to close margins of the anterior tonsil pillar and base of tongue  squamous cell carcinoma in situ extending to the base of tongue margin  recurrent disease	Pharyngeal Squamous Cell Carcinoma
hyperdiploid b acute lymphoblastic leukemia	Hyperdiploid B Acute Lymphoblastic Leukemia
rare cancers leiomyosarcoma	Leiomyosarcoma
b-cell non-hodgkin's lymphoma	B-Cell Non-Hodgkin Lymphoma
adenocarcinoma - colon final pathology dx confirmedprior dx breast cancer ctep sdc code 10006285 treatment history unknown tumor stagegrade pt4n1m0location of primary tumor transverse colonrecurrence at primary site	Colon Adenocarcinoma
rcc clear cell adenocarcinoma location of known metastasis diaphragm soft tissue of posterior body walltumor gradestage ypt3a ypnx ypm1	CLEAR CELL RENAL CELL CARCINOMA
ependymoma	EPENDYMOMA
wilms	WILMS TUMOR
squamous cell carcinoma - anus	Anal Squamous Cell Carcinoma
lung adenocarcinoma poorly differentiated  location of known metastases scalprecurrent disease distant metastasis	LUNG ADENOCARCINOMA
nasopharyngeal undifferentiated carcinoma	Nasopharyngeal Undifferentiated Carcinoma
neuroendocrine carcinoma	Pancreatic Neuroendocrine Carcinoma
acute myelomonocytic leukemia	ACUTE MYELOID LEUKEMIA
invasive breast carcinoma ductal, tnbc final pathology dx confirmed with 13 of 17 regional lymph nodes positive for malignancy and extranodal extension present positive lymphovascular invasion no definite response noted to neoadjuvant treatment tumor gradestage ypt2 ypn3a nottingham score grade 3	Metastatic Breast Ductal Carcinoma
t acute lymphoblastic leukemia	T Acute Lymphoblastic Leukemia
adenocarcinoma - colon history of prostate cancer diagnosed 2006 recurrent diseaselocation of known metastases liver	Colon Adenocarcinoma
bladder transitional cell carcinoma	Bladder Urothelial Carcinoma
anal cancer	ANAL CANCER
hodgkins lymphoma nodular sclerosis	Nodular Sclerosis Classic Hodgkin Lymphoma
adenocarcinoma - colon location of known metastases lymph node	Colon Adenocarcinoma
cutaneous melanoma	CUTANEOUS MELANOMA
non-rhabdo soft tissue sarcoma myxofibrosarcoma with epithelioid features tumor gradestage fnclcc grade 3 of 3 high grade	Myxofibrosarcoma
squamous cell carcinoma	Esophageal Squamous Cell Carcinoma
adenosquamous carcinoma	Pancreatic Adenosquamous Carcinoma
squamous cell carcinoma	SKIN SQUAMOUS CELL CARCINOMA
sezary syndrome	Sezary Syndrome
pharyngeal squam cell carcinoma patient has history of scca treated with multiple resections chemoradiation and radiation current surgery is for recurrence at primary site and metastases location of known metastases pharynx thyroid vallecularecurrent disease	Pharyngeal Squamous Cell Carcinoma
carcinosarcoma of the uterus final surgical pathology carcinosarcoma dx confirmed involvement of fimbriated surface of left fallopian tube present pathology from diagnostic biopsy  poorly differentiated endometrial adenocarcinoma figo grade 3 the sections show epithelial component consistent with endometrioid adenocarcinoma and mesenchymal homologous component  tumor gradestage figo grade 3location of known metastases fallopian tube	UTERINE CARCINOSARCOMA
head and neck cancer: lip and oral cavity squamous cell carcinoma	Lip and Oral Cavity Squamous Cell Carcinoma
pancreatic neuroendocrine carcinoma	Pancreatic Neuroendocrine Carcinoma
melanoma tumor stagegrade stage iiic, t2n3cmolocation of known metastases right axilla	CUTANEOUS MELANOMA
alveolar soft part sarcoma	SOFT TISSUE SARCOMA
pancreatic somatostatinoma	Pancreatic Cancer
adenocarcinoma - colon final pathology dx confirmed invasive into the subserosa perineural invasion +  tumor gradestage pt3pn0 low grade	COLON ADENOCARCINOMA
pancreatic cancer neuroendocrine carcinoma	Pancreatic Neuroendocrine Carcinoma
barrett s adenocarcinoma	Barrett Adenocarcinoma
colorectal cancer nos adenocarcinoma prior history of adenocarcinoma of the rectum treated with neoadjuvant chemoradiation and complete surgical resection location of known metastases lung	COLORECTAL ADENOCARCINOMA
pharyngeal squam cell carcinoma oropharyngeal patient with history of extensive surgical resections for recurrent disease at primary site recurrent disease	Oropharyngeal Squamous Cell Carcinoma
ovarian cystadenocarcinoma	Ovarian Cystadenocarcinoma
stomach cancer adenocarcinoma (nos)	Gastric Carcinoma
endometrial stromal sarcoma	Endometrioid Stromal Sarcoma
intraductal carcinoma; noninfiltrating; nos	DUCTAL BREAST CARCINOMA IN SITU
prostate cancer, nos	Prostate Carcinoma
cervical squamous cell carcinoma	Cervical Squamous Cell Carcinoma Not Otherwise Specified
invasive ductal carcinoma	INVASIVE DUCTAL CARCINOMA NOT OTHERWISE SPECIFIED
squamous cell carcinomas	Lung Squamous Cell Carcinoma
adenocarcinoma	Prostate Adenocarcinoma
stomach cancer undifferentiated carcinoma	Gastric Undifferentiated Carcinoma
small cell lung cancer	Lung Small Cell Carcinoma
adenocarcinoma - pancreas ductal final pathology dx confirmed with extensive perineural invasion in the pancreas, panin-1b and approximately 5 liver volume involved by tumor  tumor gradestage stage iv aypt4 aypn1 aypm1, poorly differentiated location of known metastases peripancreatic fat, local lymph nodes, liver, diaphragm, unilateral lung, and ascites	Pancreatic Ductal Adenocarcinoma
rhabdoid tumour of the kidney	RHABDOID TUMOR OF THE KIDNEY
lung squamous cell carcinoma	Lung Squamous Cell Carcinoma
mixed lineage lukemia acute lymphoblastic leukemia	Acute Lymphoblastic Leukemia
breast adenocarcinoma	BREAST ADENOCARCINOMA
merkel cell tumor tumor gradestage high grade	MERKEL CELL CARCINOMA
gliosarcoma	GLIOSARCOMA
breast invasive ductal carcinoma	Invasive Breast Carcinoma of No Special Type
breast cancer carcinoma	Breast Carcinoma
endometrial cancer	ENDOMETRIAL CARCINOMA
ovarian adenocarcinoma	Ovarian Adenocarcinoma
myelodysplastic syndrome	Myelodysplastic Syndrome
breast cancer (triple negative)	Triple-Negative Breast Carcinoma
esophageal squamous cell carcinoma	ESOPHAGEAL SQUAMOUS CELL CARCINOMA
adenocarcinoma - pancreas invasive moderately differentiated final pathology dx confirmed tumor invades peripancreatic soft tissues 1023 lymph nodes +	PANCREATIC ADENOCARCINOMA
leiomyosarcoma - uterus tumor gradestage stage ivlocation of known metastases lung	Uterine Corpus Leiomyosarcoma
epstein-barr virus-related burkitt s lymphoma	BURKITT LYMPHOMA
urothelialbladder cancer nos invasive papillary of the bladder sarcomatoid features concurrent malignancy adenocarcinoma of the prostate ho childhood non-hodgkins lymphoma tumor gradestage high grade	BLADDER PAPILLARY UROTHELIAL CARCINOMA
urothelialbladder cancer nos transitional cell ca family history 3 first degree relatives 1 first degree relative prostate cancer tumor gradestage ct2nxmxgrade iiilocation of known metastases lung	Bladder Papillary Urothelial Carcinoma
hodgkin's lymphoma	HODGKIN LYMPHOMA
liver/hepatobiliary cancer	Hepatobiliary Cancer
metastatic gastric neuroendocrine carcinoma	Gastric Neuroendocrine Carcinoma
h n squamous cell car nos invasive moderately differentiated final pathology tongue right - dx confirmed lymphovascular space invasion identified  212 lymph nodes at right neck levels 2 and 3  location of known metastases lymph node	TONGUE SQUAMOUS CELL CARCINOMA
serous carcinoma	Ovarian Serous Adenocarcinoma
moderately to poorly differentiated, with mucinous differentiation, t2n0mx	Colon Mucinous Adenocarcinoma
rhabdoid tumor of kidney	RHABDOID TUMOR
urothelialbladder cancer, nos papillary  final pathology focal squamous differentiation present morphological features are suggestive of large nested variant tumor gradestage high grade	Bladder Urothelial Carcinoma
gastric carcinoma	Gastric Carcinoma
papillary thyroid carcinoma	Thyroid Gland Papillary Carcinoma
stomach cancer adenocarcinoma (nos)	Gastric Adenocarcinoma
melanoma invasive	Cutaneous Melanoma
acute myeloid leukemia	ACUTE MYELOID LEUKEMIA
ependymoblastoma	Embryonal Tumor with Multilayered Rosettes C19MC-Altered
large cell lung carcinoma	LUNG LARGE CELL CARCINOMA
chondrosarcoma	CHONDROSARCOMA
ampulla of vater cancer tubulovillous adenoma	Ampulla of Vater Tubulovillous Adenoma
malig periph nerve sheath tum pleomorphic sarcoma final pathology soft tissue, left forearm, resection dx confirmed patient has findings consistent with neurofibromatosis 1 this in conjunction with the observation this sarcoma is associated with a nerve supports the diagnosis of malignant peripheral nerve sheath tumor tumor gradestage high grade	MALIGNANT PERIPHERAL NERVE SHEATH TUMOR
lung cancer carcinoma (nos)	Lung Carcinoma
urothelial/bladder cancer nos	Urinary System Cancer
adenocarcinoma - colon adenocarcinoma of splenic flexure family history 2 first degree relatives breast ca 1 first degree relative uterine cancer tumor gradestage t3n0 stage ii	Colon Adenocarcinoma
ewing's sarcoma	Ewing Sarcoma of Bone
ewing sarcomaperipheral pnet recurrent disease	EWING SARCOMA/PERIPHERAL PRIMITIVE NEUROECTODERMAL TUMOR OF BONE
micropapillary variant infiltrating bladder urothelial carcinoma	Infiltrating Bladder Urothelial Carcinoma Micropapillary Variant
infiltrating duct carcinoma; nos	Invasive Ductal Carcinoma Not Otherwise Specified
serous endometrial adenocarcinoma	Endometrial Serous Adenocarcinoma
adenocarcinoma	Rectal Adenocarcinoma
liposarcoma	Liposarcoma
combined small cell lung cancer and large cell neuroendocrine carcinoma and adenocarcinoma	Lung Adenocarcinoma
rectal cribriform comedo-type adenocarcinoma	Rectal Cribriform Comedo-Type Adenocarcinoma
leiomyosarcoma - not uterine	Leiomyosarcoma
endometrioid endomet adenocar history of uterine fibroids figo grade 1	Endometrial Endometrioid Adenocarcinoma
metastasis melanoma	CUTANEOUS MELANOMA
clivus chordoma	Clivus Chordoma
transitional cell car - uroth squamous cell differentiation	UROTHELIAL CARCINOMA
small cell car. (extrapulmonary)	Small Cell Carcinoma
vaginal cancer nos	Vaginal cancer
adenocarcinoma - pancreas	PANCREATIC ADENOCARCINOMA
urothelialbladder cancer nos high grade papillary location of known metastases kidney bowel and bladder	Bladder Papillary Urothelial Carcinoma
t-cell lymphoblastic leukemia	T Lymphoblastic Leukemia/Lymphoma
adenocarcinoma	Ampulla of Vater Adenocarcinoma
ovarian endometrioid adenocarcinoma	OVARIAN ENDOMETRIOID ADENOCARCINOMA
spindle cell sarcoma	Spindle Cell Sarcoma
transitional cell car. - uroth.	Urothelial Carcinoma
adenosquamous	Lung Adenosquamous Carcinoma
adenocarcinoma - colon invasive  final pathology dx confirmed primary tumor present at terminal ileumcecum and proximal colonconcurrent cancer endometrioid endometrial adenocarcinomafamily hx colon cancer tumor gradestagemoderately differentiated	COLON ADENOCARCINOMA
lunng adenocarcinoma	Lung Adenocarcinoma
not specified	Breast Cancer
salivary gland squamous cell carcinoma	Salivary Gland Squamous Cell Carcinoma
fibrosarcoma - not infantile myxofibrosarcoma and pleomorphic liposarcoma final pathology post-resection right anterior thigh resection dx confirmed tumor gradestage high grade fnclcc grade 33	Fibrosarcoma
lung adenocarcinoma, mucinous	LUNG ADENOCARCINOMA
adenocarcinoma	LUNG ADENOCARCINOMA
uterine cancer, nos	Uterine Cancer
ovarian cancer endometrioid carcinoma	Ovarian Endometrioid Adenocarcinoma
adenocarcinoma - colon mucinous moderately differentiated	COLON ADENOCARCINOMA
adenocarcinoma - pancreas ho breast cancer 20yrs prior treatment information not available tumor gradestage t3n1m0, stage iib	PANCREATIC ADENOCARCINOMA
clear cell renal cell carcinoma	Clear Cell Renal Cell Carcinoma
pancreatic carcinoma	PANCREATIC CARCINOMA
ovarian cancer, nos	Ovarian Cancer
lung adenocarcinoma areas of possible squamous cell differentiation present history of renal cell carcinoma dx 2012 and prostate cancer dx 2005 final pathology confirmed specimen received is from a new nsclc adenocarcinoma primary	LUNG ADENOCARCINOMA
pancreatic cancer carcinosarcoma	Pancreatic Carcinoma
other neoplasm	Lung Cancer
giant cell bone sarcoma	Malignancy in Giant Cell Tumor of Bone
squamous cell lung carcinoma invasive moderately differentiated extensive history of cancer and cancer-related mortality among primary relativesfinal pathology dx confirmed	Lung Squamous Cell Carcinoma
gastrointestinal stromal tumor history of low-grade papillary urothelial carcinoma 1year prior tumor gradestage high grade, t4nxm1	Metastatic Gastrointestinal Stromal Tumor
squamous cell lung carcinoma poorly differientiated	Lung Squamous Cell Carcinoma
metastatic breast carcinoma	Breast Carcinoma
pharyngeal squam cell carcinoma moderate to poorly differentiated final pathology dx confirmed p16+ extensive lymphovascular invasion identified  4 of 30 lymph nodes positive at levels 2a and 3ho adenocarcinoma of the distal esophagus - t4n1m1a stage iv a in 2007 location of known metastases lymph nodes	PHARYNGEAL SQUAMOUS CELL CARCINOMA
adenocarcinoma - rectum mucinous	Rectal Mucinous Adenocarcinoma
invasive breast carcinoma ductal tumor gradestage t2n0m0 clinical stage iia	INVASIVE DUCTAL CARCINOMA NOT OTHERWISE SPECIFIED
cutaneous superficial spreading malignant melanoma	CUTANEOUS MELANOMA
breast cancer, nos	Breast Cancer
gastric stromal cancer gist	MALIGNANT GASTRIC GASTROINTESTINAL STROMAL TUMOR
melanoma melanoma treated surgically only at diagnosisprior malignancy brca+ breast cancer stage 3b papillary thyroid carcinoma treated surgically only location of known metastases liver diaphragm omentum small bowel sacral ala	CUTANEOUS MELANOMA
merkel cell tumor tumor gradestage high grade	Merkel Cell Carcinoma
colorectal cancer adenocarcinoma, intestinal type	Gastric Adenocarcinoma
penile squamous car.(epidermoid)	Squamous Cell Carcinoma of the Penis
ampullary adenocarcinoma	AMPULLA OF VATER ADENOCARCINOMA
neuroblastoma	ADRENAL GLAND NEUROBLASTOMA
thyroid cancer	THYROID GLAND CANCER
non-rhabdo soft tissue sarcoma spindle cell	Spindle Cell Sarcoma
childhood precursor t lymphoblastic lymphoma	T Lymphoblastic Lymphoma
rare cancers angioimmunoblastic t-cell lymphoma	Angioimmunoblastic T-Cell Lymphoma
adenocarcinoma 90% solid with 10% acinar subtype	Solid Lung Adenocarcinoma
miscellaneous neoplasm, nos	Miscellaneous Neoplasm
childhood acute myeloid leukemia with maturation	Childhood Acute Myeloid Leukemia with Maturation
gastric small cell neuroendocrine carcinoma	Gastric Small Cell Neuroendocrine Carcinoma
adenocarcinoma - colon final pathology dx confirmed invasion into muscularis propriaconcurrent diagnosis of osteolytic chronic lymphocytic leukemia cll tumor gradestage pt2, moderately differentiated	COLON ADENOCARCINOMA
glioblastoma nos 4	Brain Glioblastoma
squamous cell lung carcinoma history of renal cell carcinoma location of known metastases skin abdomen	LUNG SQUAMOUS CELL CARCINOMA
non-rhabdo soft tissue sarcoma undifferentiated pleomorphic tumor gradestage high grade	Undifferentiated Pleomorphic Sarcoma
ns; mis; ssm melanoma	Melanoma
pancreatic cancer not islets ductal adenocarcinoma final pathology dx confirmed with microscopic tumor extension invading into duodenal wall and retroperitoneal soft tissue tumor gradestage grade 3, poorly differentiated	PANCREATIC DUCTAL ADENOCARCINOMA
nsclc (caucasian epidermoid subtype)	Lung Non-Small Cell Carcinoma
carcinosarcoma	Ovarian Carcinosarcoma
squamous cell car. - esophagus	Esophageal Squamous Cell Carcinoma
metastatic adenocarcinoma	PANCREATIC ADENOCARCINOMA
nk-t-cell lymphoma	T-Cell Non-Hodgkin Lymphoma
neuroendocrine cancer nos large cell carcinoma of the cecum final pathology dx confirmed invasive into the sigmoid colon and bladder 621 lymph nodes + mitotic rate 2910 hpf ki67 proliferation index 40-50 tumor stagegrade pt4b pn2blocation of known metastases lymph nodes	NEUROENDOCRINE NEOPLASM
adenocarcinoma - colon final pathology dx confirmed low grade with mucinous features tumor invades to the interface of the muscularis propria and pericolonic tissue with very focal lymph-vascular space invasion identified  tumor stagegrade pt3n0 ajcc, 7th edition, low grade, moderately differentiated	Colon Adenocarcinoma
liposarcoma tumor stagegrade dedifferentiated	Liposarcoma
urinary bladder urothelial carcinoma	BLADDER UROTHELIAL CARCINOMA
fibrosarcoma - not infantile myxofibrosarcoma final pathology dx confirmed tumor gradestage high grade	Myxofibrosarcoma
sarcomatoid transitional cell carcinoma	Infiltrating Bladder Urothelial Carcinoma Sarcomatoid Variant
lung pleomorphic carcinoma (with squamous cell component)	Lung Pleomorphic Carcinoma
glioblastoma multiforme mesenchymal	GLIOBLASTOMA
urothelialbladder cancer nos bladder invasive with squamous differentiation ho prostate cancer  recurrent disease at distant site high grade	BLADDER CANCER
bladder urothelial papillary carcinoma	Bladder Papillary Urothelial Carcinoma
rhabdomyosarcoma, nos	Rhabdomyosarcoma
pediatric osteosarcoma	Childhood Osteosarcoma
ovarian serous adenocarcinoma	OVARIAN SEROUS ADENOCARCINOMA
cervical poorly differentiated adenosquamous carcinoma	Cervical Poorly Differentiated Adenosquamous Carcinoma
lung adenocarcinoma adenocarcinoma tumor gradestage stage ivlocation of known metastases brain bone liver adrenal gland	Lung Adenocarcinoma
undifferentiated gallbladder carcinoma	Gallbladder Undifferentiated Carcinoma
melanoma location of known metastases lymph node	Cutaneous Melanoma
kidney cancer clear cell renal cell carcinoma	Clear Cell Renal Cell Carcinoma
mixed phenotype acute leukemia with t(v;11q23.3); kmt2a rearranged	Mixed Phenotype Acute Leukemia with t(v;11q23.3); KMT2A Rearranged
gist	Childhood Gastrointestinal Stromal Tumor
ductal adenocarcinoma	Ductal Breast Carcinoma
adenocarcinoma - colon tumor gradestage pt3n1b	COLON ADENOCARCINOMA
human papilloma virus-related cervical squamous cell carcinoma	HUMAN PAPILLOMAVIRUS-RELATED CERVICAL SQUAMOUS CELL CARCINOMA
h n squamous cell car nos	HEAD AND NECK SQUAMOUS CELL CARCINOMA
non-rhabdo soft tissue sarcoma spindle cell final pathology solitary fibrous tumor focally involving the surgical margin recurrent disease	Spindle Cell Sarcoma
glioblastoma nos	Glioblastoma Not Otherwise Specified
adenocarcinoma - pancreas tumor gradestage moderately differentiated stage ivlocation of known metastases omentum liver lungs diaphragm kidney left vertebral body lymph nodes peri-aortic -gastric -pancreatic +ascitestumor composes 90 of the liver	Pancreatic Adenocarcinoma
moderately differentiated mucinous carcinoma	Ovarian Mucinous Adenocarcinoma
adenocarcinoma - colon mucinous features ho childhood cancer wilms tumor treated with chemotherapy and radiation therapy location of known metastases livertumor gradestage iv	COLON ADENOCARCINOMA
childhood t acute lymphoblastic leukemia	Recurrent T Acute Lymphoblastic Leukemia
leiomyosarcoma - uterus recurrent disease at primary site	Uterine Corpus Leiomyosarcoma
adenocarcinoma - colon poorly differentiated with mucinous features final pathology dx confirmed invasive through muscularis propria into pericolic fat lymphovascular space invasion present 118 lymph nodes+ho prostate cancer treated with radiation tumor gradestage pt3 pn1a	Colon Adenocarcinoma
non-rhabdo soft tissue sarcoma ho previous sarcoma in 2011 chemo and radiation 12011 pathology indicates current sarcoma is a separate primary, not a recurrence tumor stagegrade intermediate grade	UNDIFFERENTIATED PLEOMORPHIC SARCOMA
nsclc (caucasian epidermoid subtype)	LUNG NON-SMALL CELL CARCINOMA
uterine corpus leiomyosarcoma	Uterine Corpus Leiomyosarcoma
sarcoma metastatic sarcoma; unknown subtype	SARCOMA
lung squamous cell carcinoma basaloid 	LUNG SQUAMOUS CELL CARCINOMA
vulvar melanoma	Vulvar Melanoma
renal cell carcinoma nos	Renal Cell Carcinoma
adrenal cortical carcinoma	ADRENAL CORTEX CARCINOMA
melanoma tumor gradestage t4bn3 iiiclocation of known metastases axillary lymph nodes	CUTANEOUS MELANOMA
synovial sarcoma	SYNOVIAL SARCOMA
liporal cavity squam cell car moderately differentiated final pathology dx confirmedprior historymelanoma - 2001glioma who grade 34 - 2009metastatic merkel cell carcinoma ear neck - 2013squamous cell carcinoma of the skin calf - 2014 tumor gradestage t4an1mx	LIP AND ORAL CAVITY SQUAMOUS CELL CARCINOMA
melanoma atypical lentiginous melanocytes wspitzoid features pathology biopsy showing atypical lentiginous melanocytic proliferation having spitzoid features location of known metastases lymph node	CUTANEOUS MELANOMA
lung cancer squamous cell carcinoma (nos)	Lung Squamous Cell Carcinoma
cns embryonal nos	Central Nervous System Embryonal Neoplasm
multifocal breast carcinoma	Multifocal Breast Carcinoma
testis cancer	Testicular Cancer
leiomyosarcoma	Bone Leiomyosarcoma
hodgkin's lymphoma	Hodgkin Lymphoma
squamous cervical cancer tumor stagegrade poorly differentiated	CERVICAL SQUAMOUS CELL CARCINOMA NOT OTHERWISE SPECIFIED
pediatric ependymoma	Childhood Ependymoma
lung adenocarcinoma   location of known metastases scalprecurrent disease distant metastasistumor stagegrade poorly differentiated	LUNG ADENOCARCINOMA
melanoma nevoid family cancer history 1st degree relative-basal cell carcinoma 2nd degree relatives-melanoma and prostate cancer tumor stagegrade t1bn0m0	Nevoid Melanoma
liporal cavity squam cell car poorly differentiated keratinizing type	Lip and Oral Cavity Squamous Cell Carcinoma
pancreatic adenosquamous carcinoma	PANCREATIC ADENOSQUAMOUS CARCINOMA
adenocarcinoma - colon moderately differentiated final surgical pathology dx confirmed invasive into pericolic fat with intravascular tumor present +118 lymph nodes	Colon Adenocarcinoma
ssm melanoma	Superficial Spreading Melanoma
adenocarcinoma - cervix pdx review of patient material confirms non-keratinizing squamous cell carcinoma with features of transitional cells location of known metastasis liver	Cervical Non-Keratinizing Squamous Cell Carcinoma
rectal adenocarcinoma	RECTAL ADENOCARCINOMA
not collected	Soft Tissue Neoplasm
epithelioid sarcoma	Childhood Epithelioid Sarcoma
adenosquamous carcinoma	Lung Adenosquamous Carcinoma
diffuse intrinsic pontine glioma	Diffuse Intrinsic Pontine Glioma
adenocarcinoma - colon poorly differentiated final pathology dx confirmed lymphatic invasion present tumor gradestage tnbm0	COLON ADENOCARCINOMA
hereditary spherocytosis	Hereditary Spherocytosis
small cell lung cancer prior ho scc of lung 2017 adenocarcinoma of the lung 2018family ho cancer 1st degree relative, cervical cancer location of known metastases liver	Lung Small Cell Carcinoma
lung cancer nos undifferentiated carcinoma final pathology dx confirmed poorly differentiated malignant neoplasm favor undifferentiated carcinoma per patchy staining for oscar cytokeratin extensive lymphatic invasion focal pleural invasion confirmed by movat staining findings may fit best with large cell undifferentiated carcinoma compatible with lung primary and has been staged as such the possibility that this represents metastasis cannot be entirely excluded   tumor stagegrade pt2a pn0 ajcc 7th ed 2010 grade 4	LUNG CARCINOMA
ovarian epithelial cancer serous carcinoma  concurrent diagnosis breast cancer nos diagnosed 2014 treated with surgery, rt and chemotherapy currently metastatic to bone	Ovarian Serous Adenocarcinoma
rhabdomyosarcoma nos prior malignancy leiomyosarcoma superficial 10 yrs prior tumor stagegrade high grade	Rhabdomyosarcoma
invasive carcinoma	Lung Carcinoma
liposarcoma tumor gradestage grade 3 fnclcc pt2bpn0, dedifferentiated	Liposarcoma
ductal carcinoma in situ	Ductal Breast Carcinoma In Situ
lung adenocarcinoma areas of squamous cell differentiation present history of renal cell carcinoma dx 2012 and prostate cancer dx 2005 final pathology confirmed specimen received is from a new nsclc adenocarcinoma primary	LUNG ADENOCARCINOMA
adenosquamous carcinoma	PANCREATIC ADENOSQUAMOUS CARCINOMA
soft tissue sarcoma	Soft Tissue Sarcoma
vulvar leiomyosarcoma	Vulvar Leiomyosarcoma
melanoma final pathology report dx confirmed with desmoplastic features mitotic activity is noted in the tumor 2mm2 necrosis is focally present involving approximately 20 of the specimen recurrent disease primary site	Cutaneous Melanoma
adenocarcinoma - colon moderately differentiated final pathology dx confirmed invasion into muscularis propriaconcurrent diagnosis of osteolytic chronic lymphocytic leukemia cll tumor gradestage pt2	Colon Adenocarcinoma
gastric carcinoma	GASTRIC CARCINOMA
nodular melanoma	NODULAR MELANOMA
urothelialbladder cancer nos high-grade invasive papillary of the bladder recurrent disease primary siteinvasive into muscularis propria	Bladder Papillary Urothelial Carcinoma
female reprod system cancer, nos adenocarcinoma with intestinal features final pathology morphological features are consistent with metastasis from patients known adenocarcinoma with intestinal differentiation patient was registered as ovarian cancer, nos adenocarcinoma with intestinal features the pdx outgrowth was of endometrial adenocarcinoma with intestinal features the diagnosis was reclassified to female reproductive nos location of known metastases lung	Adenocarcinoma
head and neck cancer	Pharyngeal Cancer
malignant fibrous histiocytoma pleomorphic sarcoma tumor stagegrade undifferentiated	Undifferentiated Pleomorphic Sarcoma
renal cancer	KIDNEY CANCER
ovarian endometrioid adenocarcinoma	Ovarian Endometrioid Adenocarcinoma
radiation therapy induced osteosarcoma; 2nd isolation from same patient as shim1	Osteosarcoma
non-rhabdo soft tissue sarcoma spindle cell final pathology solitary fibrous tumor focally involving the surgical margin   recurrent disease	SPINDLE CELL SARCOMA
laryngeal squamous cell carcinoma recurrent disease	Laryngeal Squamous Cell Carcinoma
ovarian epithelial cancer serous carcinoma tumor gradestage high grade	OVARIAN CARCINOMA
merkel cell tumor	MERKEL CELL CARCINOMA
dedifferentiated liposarcoma	Dedifferentiated Liposarcoma
non-rhabdo soft tissue sarcoma spindle cell with myxoid changes final surgical pathology dx confirmed mitotic rate 2410hpf 30 necrosis 60 viable 5 cystichemorrhagic tumor gradestage pt2b pnx pmx high grade	SOFT TISSUE SARCOMA
adenocarcinoma - rectum invasive tumor gradestage moderately differentiated, stage iii	RECTAL ADENOCARCINOMA
head and neck cancer: lip and oral cavity squamous cell carcinoma, conventional	Tongue Squamous Cell Carcinoma
small cell lung cancer	LUNG SMALL CELL CARCINOMA
non-rhabdo soft tissue sarcoma undifferentiated pleomorphic  tumor gradestage high grade	UNDIFFERENTIATED PLEOMORPHIC SARCOMA
malig periph nerve sheath tum recurrence at primary sitetumor gradestage rt2bn0m0 grade 4	Malignant Peripheral Nerve Sheath Tumor
t3n1mx triple neg	Triple-Negative Breast Carcinoma
adenocarcinoma - colon location of known metastases lungtumor gradestage stage iv	COLON ADENOCARCINOMA
follicular thyroid carcinoma	Thyroid Gland Follicular Carcinoma
liporal cavity squam cell car final pathology dx confirmed +432 lymph nodes tumor gradestage pt2n2b moderately differentiated	LIP AND ORAL CAVITY SQUAMOUS CELL CARCINOMA
hepatosplenic t-cell lymphoma	HEPATOSPLENIC T-CELL LYMPHOMA
biphasic mesothelioma	PLEURAL BIPHASIC MESOTHELIOMA
adenocarcinoma - colon final surgical pathology dx confirmed invasive into pericolic fat with intravascular tumor present +118 lymph nodes tumor stagegrade moderately differentiated	COLON ADENOCARCINOMA
islet cell tumors - pancreas	Pancreatic Neuroendocrine Carcinoma
rare cancers mature t-cell lymphoma	Mature T-Cell and NK-Cell Non-Hodgkin Lymphoma
invasive carcinoma	PANCREATIC CARCINOMA
bladder adenocarcinoma	Bladder Adenocarcinoma
adenocarcinoma - colon past med hxliver disease past surg hxtotal colectomy location of known metastases livertumor gradestage stage iv, moderately differentiated	Colon Adenocarcinoma
melanoma	Cutaneous Melanoma
oral cavity squamous cell carcinoma	ORAL CAVITY SQUAMOUS CELL CARCINOMA
sarcoma	Sarcoma
lung adenocarcinoma tumor stagegrade stage iii ajcc grade 3	LUNG ADENOCARCINOMA
rectosigmoid adenocarcinoma	Rectosigmoid Adenocarcinoma
adenocarcinoma - pancreas location of known metastases liver colon myometrium diaphragm	Pancreatic Adenocarcinoma
non-small cell lung cancer nos adenosquamous carcinoma final pathology the morphological and immunophenotypical features are compatible with adenosquamous carcinoma however mucoepidermoid carcinoma cannot be entirely ruled outho multifocal bronchioloalveolar carcinoma bac	Lung Non-Small Cell Carcinoma
glioma	Glioma
invasive carcinoma	Invasive Breast Carcinoma
adenocarcinoma (60% acinar and 30% micropapillary and 10% sarcomatoid)	Lung Acinar Adenocarcinoma
brain glioblastoma multiformebrain glioblastoma multiforme	Brain Glioblastoma
adenocarcinoma	Liver and Intrahepatic Bile Duct Carcinoma
follicular lymphoma	FOLLICULAR LYMPHOMA
carcinoid	Lung Carcinoid Tumor
urinary bladder urothelial carcinoma	Bladder Urothelial Carcinoma
askin's tumor	Askin Tumor
adenocarcinoma	OVARIAN ADENOCARCINOMA
adenocarcinoma - colon appendiceal	Colon Adenocarcinoma
squamous	Lung Squamous Cell Carcinoma
non-rhabdo soft tissue sarcoma mesenchymal tumor compatible with myxofibrosarcoma final pathology dx confirmed locally invasive and infiltrative to muscle adipose and surrounding glandular tissue fnclcc grade 2 of 3	Myxosarcoma
squamous cell lung carcinoma patient was registered as nsclc nos the pdx outgrowth was of a squamous cell lung carcinoma the diagnosis was reclassified	Lung Squamous Cell Carcinoma
melanoma final pathology dx confirmed, involving dermis and subcutaneous tissue favoring melanoma based on ihc 80 tumor necrosis present, 50 mitotic figures10 hpf  tumor stagegrade undifferentiated	CUTANEOUS MELANOMA
unknown	Breast Cancer
hypopharyngeal squamous cell carcinoma	HYPOPHARYNGEAL SQUAMOUS CELL CARCINOMA
adenocarcinoma - colon invasive signet ring cells and mucinous features final pathology dx confirmed with signet ring cells and mucinous features invasive into muscularis propria  tumor stagegrade pt2 n0, moderately differentiated	COLON ADENOCARCINOMA
invasive breast carcinoma ductal tnbc	Triple-Negative Breast Carcinoma
pancreatic adenocarcinoma	PANCREATIC ADENOCARCINOMA
epstein-barr virus-related burkitt s lymphoma	Burkitt Lymphoma
metaplastic spindle	Breast Adenocarcinoma with Spindle Cell Metaplasia
pancreatic cancer (caucasian)	PANCREATIC CANCER
chronic lymphocytic leukemia	Chronic Lymphocytic Leukemia
adenocarcinoma - colon tumor gradestage t3n2mx	Colon Adenocarcinoma
brain glioblastoma multiforme	Brain Glioblastoma
head and neck squamous cell carcinoma	Glottic Squamous Cell Carcinoma
squamous cell carcinoma	Skin Squamous Cell Carcinoma
adenocarcinoma	Colon Adenocarcinoma
pancreatic somatostatinoma	Pancreatic Somatostatinoma
ovarian mucinous adenocarcinoma	OVARIAN MUCINOUS ADENOCARCINOMA
colon cancer (caucasian, europe)	COLON CANCER
ovarian granulosa cell tumor	Malignant Ovarian Granulosa Cell Tumor
pharyngeal squam cell carcinoma oropharyngeal	Oropharyngeal Squamous Cell Carcinoma
extracranial rhabdoid	Recurrent Rhabdoid Tumor
intrahepatic cholangiocarcinoma	INTRAHEPATIC CHOLANGIOCARCINOMA
pancreas adenocarcinoma	Pancreatic Adenocarcinoma
pleuramesothelioma	PLEURAL MESOTHELIOMA
not collected	Pancreatic Neoplasm
uterine corpus myxoid leiomyosarcoma	Uterine Corpus Myxoid Leiomyosarcoma
thyroid gland sarcoma	Thyroid Gland Sarcoma
liver cancer (caucasian, cholangiocarcinoma)	Cholangiocarcinoma
adenocarcinoma - colon moderately to poorly differentiated final pathology dx confirmed with focal tumor budding tumor invades through muscularis propria into percolic fat lymphovascular perineural and extramural large vein invasion present  521 lymph nodes + location of known metastases lymph nodestumor gradestage pt3n2a	COLON ADENOCARCINOMA
bone ewings sarcoma	Ewing Sarcoma of Bone
urothelialbladder cancer nos mucinous adenocarcinoma	Bladder Mucinous Adenocarcinoma
t3n1mx, triple neg	Triple-Negative Breast Carcinoma
high grade ovarian serous adenocarcinoma	HIGH GRADE OVARIAN SEROUS ADENOCARCINOMA
lung adenocarcinoma tumor stagegrade stage iiib, pt1n1mx, grade 2	LUNG ADENOCARCINOMA
endometrioid endomet. adenocar.	ENDOMETRIAL ENDOMETRIOID ADENOCARCINOMA
adenocarcinoma - rectum well to moderately-differentiated final pathology dx confirmed bladder adventitia involvement pathologic staging pt4b pn0	Rectal Adenocarcinoma
invasive breast carcinoma ductal tumor gradestage ia t1n0m0 pt2n0	Invasive Breast Carcinoma of No Special Type
adenocarcinoma - colon mucinous	Colon Mucinous Adenocarcinoma
anaplastic oligodendroglioma	ANAPLASTIC OLIGODENDROGLIOMA NOT OTHERWISE SPECIFIED
monophasic synovial sarcoma	Monophasic Synovial Sarcoma
nsclc	LUNG NON-SMALL CELL CARCINOMA
melanoma --	Cutaneous Melanoma
urothelialbladder cancer, nos  papillary carcinoma of the urinary bladder tumor stagegrade high-grade	Bladder Papillary Urothelial Carcinoma
lung adenocarcinoma + neuroendocrine differentiation	LUNG ADENOCARCINOMA
adenocarcinoma - colon patient had synchronous primary malignancies adenocarcinoma colon sdc 10009951 and rcc, clear cell adenocarcinoma sdc 10009251 only colon primary gave rise to pdmr modelsfinal pathology colon, recto-sigmoid invasive through muscularis propria with focal serosal involvement  lymphovascular and perineural invasion identified 118 mesenteric lymph nodes positive for disease biopsy confirmed distant metastases to liver consistent with colonic primarykidney, left clear cell renal cell carcinoma whoisup grade 3, confined to kidney without capsular penetration focal tumor necrosis identified vascular invasion identified  tumor stagegrade moderately differentiatedlocation of known metastases liver	COLON ADENOCARCINOMA
amelanotic melanoma	AMELANOTIC CUTANEOUS MELANOMA
breast cancer metaplastic ductal carcinoma	Breast Metaplastic Carcinoma
b-cell lymphoma unclassifiable with features intermediate between diffuse large b-cell lymphoma and classic hodgkin lymphoma	B-CELL LYMPHOMA UNCLASSIFIABLE WITH FEATURES INTERMEDIATE BETWEEN DIFFUSE LARGE B-CELL LYMPHOMA AND CLASSIC HODGKIN LYMPHOMA
adenocarcinoma	Breast Adenocarcinoma
pancreatic cancer signet ring cell carcinoma	Pancreatic Signet Ring Cell Carcinoma
endometrial cancer serous carcinoma	Endometrial Serous Adenocarcinoma
bladder signet ring cell adenocarcinoma	Bladder Signet Ring Cell Adenocarcinoma
vaginal cancer, nos invasive non-keratinizing squamous cell carcinoma  final path dx confirmed + lymphovascular invasion at primary and metastatic locations prior ho endometrioid endometrial adenocarcinoma, surgery only metastatic location suburethral, lymph nodestumor stagegrade poorly differentiated	VAGINAL SQUAMOUS CELL CARCINOMA NOT OTHERWISE SPECIFIED
non-acral cutaneousmelanoma	Cutaneous Melanoma
mucinous adenocarcinoma of the colon per path report	COLON MUCINOUS ADENOCARCINOMA
lumb	Luminal B Breast Carcinoma
vaginal cancer nos invasive moderately differentiated squamous cell carcinoma	Vaginal Squamous Cell Carcinoma Not Otherwise Specified
mucinous noncystic adenoca	Pancreatic Colloid Carcinoma
carcinoma	Gastric Carcinoma
inflammatory breast carcinoma	Breast Inflammatory Carcinoma
adenocarcinoma - colon mucinous features final pathology dx confirmed invasive through muscularis propria into pericolic fat lymphovascular space invasion present 118 lymph nodes+ho prostate cancer, treated with radiation tumor gradestage pt3 pn1a, poorly differentiated	Colon Mucinous Adenocarcinoma
adult immunoblastic lymphoma	Immunoblastic Lymphoma
renal pelvis urothelial carcinoma	Renal Pelvis Urothelial Carcinoma
adenocarcinoma - colon moderately differentiated past med hxliver disease past surg hxtotal colectomy location of known metastases livertumor gradestage stage iv	Colon Adenocarcinoma
carcinosarcoma of the uterus final surgical pathology carcinosarcoma dx confirmed involvement of fimbriated surface of left fallopian tube present pathology from diagnostic biopsy poorly differentiated endometrial adenocarcinoma figo grade 3 the sections show epithelial component consistent with endometrioid adenocarcinoma and mesenchymal homologous component tumor gradestage figo grade 3location of known metastases fallopian tube	Uterine Carcinosarcoma
metastatic adenocarcinoma	Pancreatic Adenocarcinoma
breast adenocarcinoma	Breast adenocarcinoma
malignant fibrous histiocytoma undifferentiated pleomorphic sarcoma tumor gradestage high-grade, undifferentiated	Undifferentiated Pleomorphic Sarcoma
urothelialbladder cancer nos squamous cell carcinoma of the bladder	Bladder Squamous Cell Carcinoma
adenocarcinoma - rectum final pathology dx confirmed bladder adventitia involvement tumor stagegrade pt4b pn0 well to moderately-differentiated	RECTAL ADENOCARCINOMA
epithelioid sarcoma	EPITHELIOID SARCOMA
glioblastoma idh wildtype 4	GLIOBLASTOMA IDH-WILDTYPE
colon adenoma	Colon Adenoma
colon carcinoma	COLON CARCINOMA
invasive breast carcinoma ductal final pathology dx confirmed multifocal high grade dcis present, comedo and solid types tumor gradestaging elston-ellis grade 2primary tumor pt2 pn1alocation of known metastases lymph nodes	Invasive Breast Carcinoma of No Special Type
invasive breast carcinoma ductal	Invasive Breast Carcinoma of No Special Type
intraductal breast neoplasm	Invasive Ductal Carcinoma Not Otherwise Specified
rare cancers prolymphocytic leukemia, t-cell type	T-CELL PROLYMPHOCYTIC LEUKEMIA
adenocarcinoma - pancreas final pathology dx confirmed with 5 liver involvement tumor gradestage stage iii t4n0primary tumor site uncinate process of the pancreaslocation of known metastases liver lungs abdominal aorta diaphragm	PANCREATIC ADENOCARCINOMA
urinary bladder cancer	Bladder Cancer
squamous cell lung carcinoma final pathoogy dx confirmed tumor involves main bronchus and extends into lung parenchyma  216 lymph nodes + for disease in hilar region and at level 7 extranodal extension tumor stagegrade poorly differentiated	LUNG SQUAMOUS CELL CARCINOMA
metaplastic	Breast Metaplastic Carcinoma
ovarian epithelial cancer papillary serous cystadenocarcinoma  history of papillary thyroid carcinoma 10yrs prior treated surgically only	Papillary Serous Cystadenocarcinoma
transitional cell car - uroth invasive final pathology dx confirmed extensive necrosis, indeterminate lymph-vascular invasion  tumor stagegrade high grade 3 of 3	Urothelial Carcinoma
uterus cancer	UTERINE CANCER
pharyngeal squam cell carcinoma oropharyngeal recurrent disease	Oropharyngeal Squamous Cell Carcinoma
squamous cell carcinoma	Duodenal Carcinoma
pharyngeal squam cell carcinoma moderate to poorly differentiated final pathology dx confirmed p16+ extensive lymphovascular invasion identified 4 of 30 lymph nodes positive at levels 2a and 3ho adenocarcinoma of the distal esophagus - t4n1m1a stage iv a in 2007 location of known metastases lymph nodes	Pharyngeal Squamous Cell Carcinoma
b-cell lymphoma	B-Cell Non-Hodgkin Lymphoma
rare cancers spindle cell sarcoma	Spindle Cell Sarcoma
fusion negative rhabdomyosarcoma	Fusion-Negative Rhabdomyosarcoma
invasvie ductal carcinoma	INVASIVE DUCTAL CARCINOMA NOT OTHERWISE SPECIFIED
malignant fibrous histiocytoma pleomorphic tumor stagegrade high-grade, undifferentiated recurrent disease at primary site soft tissue mass in thigh	UNDIFFERENTIATED PLEOMORPHIC SARCOMA
non-acral melanoma	Cutaneous Melanoma
sarcoma leiomyosarcoma	LEIOMYOSARCOMA
choriocarcinoma	Gestational Choriocarcinoma
poorly differentiated squamous carcinoma with focal glandular formation of poorly differentiated adenocarcinoma	Lung Adenosquamous Carcinoma
oesophagus cancer	Esophageal Cancer
mycosis fungoides and sezary syndrome	Mycosis Fungoides and Sezary Syndrome
pediatric edendymoma	Childhood Ependymoma
squamous cervical cancer poorly differentiated	Cervical Squamous Cell Carcinoma Not Otherwise Specified
embroyonal sarcoma	Undifferentiated (Embryonal) Sarcoma
non-rhabdo soft tissue sarcoma spindle cell sarcoma	Spindle Cell Sarcoma
cystic papillary carcinoma	Intracystic Papillary Breast Carcinoma
not specified	Kidney Cancer
transitional cell carcinoma, t3bnxmx	Transitional Cell Carcinoma
urothelialbladder cancer nos invasive of the bladder with focal squamous differentiation high grade invasive to muscularis propria	BLADDER CANCER
adult b acute lymphoblastic leukemia	B Acute Lymphoblastic Leukemia
metastasis sarcoma	Sarcoma
melanoma --	Signet Ring Melanoma
mucinous adenocarcinoma	Pancreatic Adenocarcinoma
squamous cell carcinoma	Colon Squamous Cell Carcinoma
other tubulovillous adenoma	Tubulovillous Adenoma
ewing's sarcoma	EWING SARCOMA OF BONE
vulvar cancer nos squamous cell carcinoma	Vulvar Squamous Cell Carcinoma
t-cell adult acute lymphocytic leukemia	T Acute Lymphoblastic Leukemia
pharyngeal squamous cell carcinoma	PHARYNGEAL SQUAMOUS CELL CARCINOMA
squamous cell car - esophagus invasive keratinizing final pathology dx confirmed keratinizing with extensive necrosis lymphovascular and perineural invasion identifiedho stage iva pt3 pn2 m0 scc of the supraglottis larynx 5years prior tumor stagegrade moderately differentiated	ESOPHAGEAL SQUAMOUS CELL CARCINOMA
claudin-low	Breast Carcinoma
malignant non-hodgkin lymphoma, cleaved cell	Non-Hodgkin Lymphoma
moderate to poorly differentiated squamous cell carcinoma (3.0 cm in maximal  dimension)	Lung Squamous Cell Carcinoma
female reproductive endometrioid cancer	Endometrioid Tumor
mucosal melanoma	MUCOSAL MELANOMA
giant cell glioblastoma	Giant Cell Glioblastoma
adenocarcinoma - pancreas poorly differentiated  tumor gradestage ypt1c ypn0 pm not applicable	Pancreatic Adenocarcinoma
head and neck squamous cell carcinoma	Postcricoid Squamous Cell Carcinoma
adenocarcinoma - colon first degree relative, non-hodgkins lymphoma tumor stagegrade stage iii, pt4apn2bm0 at diagnosislocation of known metastases brain	COLON ADENOCARCINOMA
adenocarcinoma - pancreas tumor gradestage ypt2n0 location of known metastases liver pericardium omentum small bowel mesentery	PANCREATIC ADENOCARCINOMA
breast metaplastic carcinoma	Metaplastic Breast Carcinoma
colorectal cancer nos invasive adenocarcinoma  location of known metastases liver	Colorectal Adenocarcinoma
liporal cavity squam cell car moderately differentiated final pathology dx confirmed +432 lymph nodes tumor gradestage pt2n2b	Lip and Oral Cavity Squamous Cell Carcinoma
adrenal gland neuroblastoma	Adrenal Gland Neuroblastoma
h & n squamous cell car., nos	Head and Neck Squamous Cell Carcinoma
urothelialbladder cancer nos small cell bladder cancer	Bladder Small Cell Carcinoma
wilms tumor	Childhood Kidney Wilms Tumor
metastatic adenocarcinoma	Kidney Carcinoma
malignant peripheral nerve sheath tumor	Malignant Peripheral Nerve Sheath Tumor
brain glioblastoma	BRAIN GLIOBLASTOMA
endometrioid endomet adenocar history of uterine fibroids  figo grade 1	ENDOMETRIAL ENDOMETRIOID ADENOCARCINOMA
extranodal marginal zone lymphoma of mucosa-associated lymphoid tissue	Extranodal Marginal Zone Lymphoma of Mucosa-Associated Lymphoid Tissue
adenocarcinoma - pancreas moderately differentiated final pathology dx confirmed with dense desmoplastic structure 40 of liver involved invasive through the muscularis propria of the colon pancreas findings of panin-1a patient with suspected lynch syndrome tumor gradestage grade ivlocation of known metastases bilateral adrenal glands diaphragm colon liver carcinomatosis	PANCREATIC ADENOCARCINOMA
head and neck squamous cell carcinoma	Buccal Mucosa Squamous Cell Carcinoma
malig periph nerve sheath tum patient hx of neurofibromatosis disease recurrence at primary site	MALIGNANT PERIPHERAL NERVE SHEATH TUMOR
melanoma undifferentiated final pathology dx confirmed involving dermis and subcutaneous tissue favoring melanoma based on ihc 80 tumor necrosis present 50 mitotic figures10 hpf	Cutaneous Melanoma
sarcoma sarcoma from lung met; unknown subtype	Sarcoma
rare cancers extrahepatic cholangiocarcinoma	EXTRAHEPATIC BILE DUCT CARCINOMA
cancer	Exocrine Pancreas Cancer
h n squamous cell car nos invasive moderately differentiated final pathology dx confirmed with direct extension into auditory canal skin parotid gland and temporal bone +lymphovascular and perineural invasion with positive margins 2 level 2b of 62 lymph nodes examined + for metastatic carcinoma +extranodal extensionprior malignancy rcc treated surgically only with no known recurrence to date tumor gradestage pt3 pn2blocation of metastases lymph nodes	HEAD AND NECK SQUAMOUS CELL CARCINOMA
neuroendocrine tumor	Bladder Neuroendocrine Carcinoma
basal cell carcinoma	Skin Basal Cell Carcinoma
adenocarcinoma - colon invasive poorly differentiated location of known metastases liver	COLON ADENOCARCINOMA
cutaneous t-cell lymphoma	Primary Cutaneous T-Cell Non-Hodgkin Lymphoma
adenocarcinoma - colon invasive poorly differentiated location of known metastases liver	Colon Adenocarcinoma
b-cell adult acute lymphocytic leukemia	Adult B Acute Lymphoblastic Leukemia
rcc clear cell adenocarcinoma final surgical pathology dx confirmed with focal sarcomatoid differentiation 15 lymphovascular space invasion present sinus fat involved by tumor tumor gradestage fuhrman nuclear grade 44	Clear Cell Renal Cell Carcinoma
squamous cell lung carcinoma final pathology lung, left lower lobe dx confirmed pleural surface involved by tumor lymphovascular space invasion identified patient with known ho asbestos exposure tumor stagegrade moderately differentiated	LUNG SQUAMOUS CELL CARCINOMA
female reprod system cancer nos carcinosarcoma final clinical histology carcinosarcoma of unknown origin not mesothelioma not ovarianlocation of primary disease unknown location of primary disease unknown	Carcinosarcoma
fibrosarcoma	FIBROSARCOMA
adenocarcinoma - colon final pathology dx confirmed with focal tumor budding tumor invades through muscularis propria into percolic fat lymphovascular, perineural and extramural large vein invasion present  521 lymph nodes + location of known metastases lymph nodestumor gradestage pt3n2a, moderately to poorly differentiated	COLON ADENOCARCINOMA
adenocarcinoma - colon invasive moderately differentiated mucinous tumor gradestage t3n0m0 stage iia	COLON ADENOCARCINOMA
combined hepatocellular carcinoma and cholangiocarcinoma	Combined Hepatocellular Carcinoma and Cholangiocarcinoma
salivary gland cancer acinic cell location of known metastases liver	Salivary Gland Acinic Cell Carcinoma
ovarian leiomyosarcoma	Ovarian Leiomyosarcoma
ewing sarcoma	Extraskeletal Ewing Sarcoma
central nervous system cancer	CENTRAL NERVOUS SYSTEM CANCER
ad and sc carcinoma	Lung Adenosquamous Carcinoma
unknown	OVARIAN CANCER
adenocarcinoma - pancreas	Pancreatic Adenocarcinoma
adenocarcinoma - colon final pathology dx confirmed invasion into muscularis propriaconcurrent diagnosis of osteolytic chronic lymphocytic leukemia cll tumor gradestage pt2 moderately differentiated	COLON ADENOCARCINOMA
mis melanoma	Stage 0 Cutaneous Melanoma AJCC v6 and v7
undifferentiated pleomorphic sarcoma	UNDIFFERENTIATED PLEOMORPHIC SARCOMA
synovial sarcoma final pathology dx confirmed, spindle cell type lung mass arises in lung parenchyma and extends into the bronchial lumen +lymphovascular space invasion 10 necrosis present mitotic rate 35 per 10 hpflocation of metastases pelvic mass confirmed differentiated synovial sarcoma involving bone at margins with angiolypmhatic and lymphovascular space invasion mitotic rate 21 mitoses per 10 hpf, minimal necrosis present  tumor gradestage lung pt1 pn0 ptnm, ajcc classification, 8th ed stage iv grade 3 fnclcc poorly differentiated high-gradelocation of metastases pelvic mass tumor gradestage pelvic mass pt2 grade 3 fnclcc	Synovial Sarcoma
testis cancer	TESTICULAR CANCER
lung squamous cell carcinoma basaloid	LUNG SQUAMOUS CELL CARCINOMA
buccal mucosa squamous cell carcinoma	Buccal Mucosa Squamous Cell Carcinoma
fibrosarcoma - not infantile myxofibrosarcoma recurrence at primary sitetumor gradestage intermediate to high grade	Fibrosarcoma
colorectal cancer medullary carcinoma	Colorectal Medullary Carcinoma
cervix cancer, caucasian	CERVICAL CANCER
transitional cell car - uroth tumor gradestage pt2bnxmx high-grade	Urothelial Carcinoma
ovarian cancer serous cystadenoma, borderline	Ovarian Serous Cystadenoma
adrenal cortex carcinoma	Adrenal Cortex Carcinoma
rectum adenocarcinoma	Rectal Adenocarcinoma
lung adencarcinoma	Lung Adenocarcinoma
adenocarcinoma - rectum final pathology dx confirmed consistent with origin from colorectal primary location of known metastases liver	Rectal Adenocarcinoma
squamous cervical cancer poorly differentiated	CERVICAL SQUAMOUS CELL CARCINOMA NOT OTHERWISE SPECIFIED
urothelialbladder cancer nos bladder muscle invasive	Bladder Cancer
sarcoma braf mutated gist	Gastrointestinal Stromal Tumor
pharyngeal squam cell carcinoma invasive poorly differentiated	Pharyngeal Squamous Cell Carcinoma
adenocarcinoma - colon focally invasive final pathology confirms dx with moderate tumor budding invasion through the muscularis propria into pericolonic tissue suspicious for lymphovascular and perineural invasion tumor gradestage low-grade	Colon Adenocarcinoma
keratoacanthoma	Keratoacanthoma
lung pleomorphic carcinoma (with adenocarcinoma component)	LUNG PLEOMORPHIC CARCINOMA
moderately to poorly differentiated with mucinous differentiation t2n0mx	Colon Mucinous Adenocarcinoma
yolk sac tumor	Ovarian Yolk Sac Tumor
urothelialbladder cancer nos invasive urothelial carcinoma of the bladder patient ebv+ tumor gradestage high-gradelocation of known metastases kidney	Bladder Urothelial Carcinoma
squamous cervical cancer	Cervical Squamous Cell Carcinoma Not Otherwise Specified
colorectal cancer, nos	colorectal cancer
lung adenocarcinoma tumor gradestage t2an0m0	LUNG ADENOCARCINOMA
melanoma tumor stagegrade pt3an1bmx stage iiiblocation of known metastases lymph nodes	CUTANEOUS MELANOMA
adenocarcinoma - colon recurrent disease	COLON ADENOCARCINOMA
carcinoma	Endometrial Carcinoma
follicular lymphoma	Follicular Lymphoma
invasive moderately differentiated lung adenocarcinoma; papillary predominant  (60% papillary and 40% acinar subtypes);	Lung Papillary Adenocarcinoma
gastrointestinal stromal tumor	GASTROINTESTINAL STROMAL TUMOR
nsclc (caucasian adenocarcinoma subtype)	Lung Non-Small Cell Carcinoma
adenocarcinoma - colon final pathology dx confirmed lymphatic invasion present tumor gradestage tnbm0, poorly differentiated	COLON ADENOCARCINOMA
squamous cell lung carcinoma patient originally enrolled with lung adenocarcinoma review of pdx histology resulted in a change in diagnosis to scc	LUNG SQUAMOUS CELL CARCINOMA
small cell carcinoma	Small Cell Carcinoma
adenocarcinoma; metastatic; nos	breast adenocarcinoma
squamous cell car - esophagus invasive moderately differentiated keratinizing final pathology dx confirmed keratinizing with extensive necrosis lymphovascular and perineural invasion identifiedho stage iva pt3 pn2 m0 scc of the supraglottis larynx 5years prior	Esophageal Squamous Cell Carcinoma
melanoma invasive	Invasive Cutaneous Melanoma
urothelialbladder cancer nos papillary bladder cancer final pathology dx confirmed high grade with invasion of the perivascular tissue  tumor gradestage high grade	BLADDER PAPILLAR UROTHELIAL CARCINOMA
chronic myelomonocytic leukaemia to acute myeloid leukemia	Leukemia
urothelialbladder cancer nos papillary tumor gradestage high grade	Urinary System Cancer
adenocarcinoma	PANCREATIC ADENOCARCINOMA
lung cancer, nos carcinoma final pathology dx confirmed poorly differentiated malignant neoplasm, favor undifferentiated carcinoma per patchy staining for oscar cytokeratin extensive lymphatic invasion, focal pleural invasion confirmed by movat staining findings may fit best with large cell undifferentiated carcinoma compatible with lung primary and has been staged as such the possibility that this represents metastasis cannot be entirely excluded   tumor stagegrade pt2a pn0 ajcc, 7th ed, 2010 grade 4, undifferentiated	Lung Carcinoma
adenocarcinoma; metastatic; nos	Breast adenocarcinoma
rare cancers papillary carcinoma, nos	Thyroid Gland Papillary Carcinoma
vaginal cancer nos invasive poorly differentiated non-keratinizing squamous cell carcinoma final path dx confirmed + lymphovascular invasion at primary and metastatic locations prior ho endometrioid endometrial adenocarcinoma surgery only metastatic location suburethral lymph nodes	Vaginal Squamous Cell Carcinoma Not Otherwise Specified
endometrioid adenocarcinoma	Endometrioid Adenocarcinoma
urothelialbladder cancer nos invasive papillary tumor gradestage high grade invasive to the lamina propriarecurrent disease	Bladder Papillary Urothelial Carcinoma
non-rhabdo soft tissue sarcoma pleomorphic, dermal  tumor stagegrade undifferentiated	UNDIFFERENTIATED PLEOMORPHIC SARCOMA
astrocytoma	Astrocytoma
well differentiated liposarcoma	Superficial Atypical Lipomatous Tumor_and_Well Differentiated Liposarcoma
laryngeal squamous cell carcinoma invasive final pathology dx confirmed transglottic involving paraglottic space and cricoid cartilage extensive perineural invasion focal lymphovascular invasion present 1 of 11 lymph nodes positive at level 2a tumor gradestage t3n0, moderately to poorly differentiated	Laryngeal Squamous Cell Carcinoma
not specified	Soft Tissue Cancer
acute lymphocytic leukemia	Acute Lymphoblastic Leukemia
leiomyosarcoma - not uterine final path dx confirmed tumor stagegrade grade 3	LEIOMYOSARCOMA
melanoma ho right parotid mass ho premalignant melanoma final pathology dx confirmed involving intaparotid lymph node extranodal extension indentified location of known metastases parotid gland	Cutaneous Melanoma
retinoblastoma	Childhood Intraocular Retinoblastoma
endometrioid endomet adenocar tumor gradestage grade ivlocation of known metastases lung	Endometrial Endometrioid Adenocarcinoma
head and neck cancer: lip and oral cavity squamous cell carcinoma, keratinizing	Head and Neck Keratinizing Squamous Cell Carcinoma
pleomorphic carcinoma (15%) with poorly differentiated squamous carcinoma (85%)	Lung Squamous Cell Carcinoma
adenocarcinoma - colon location of known metastasis liver	Colon Adenocarcinoma
nsclc (caucasian, adenocarcinoma subtype)	LUNG NON-SMALL CELL CARCINOMA
liposarcoma	Childhood Liposarcoma
childhood precursor b lymphoblastic leukemia	B Lymphoblastic Leukemia/Lymphoma
metastasis colon	Colorectal Cancer
mediastinal thymic large b-cell cell lymphoma	Primary Mediastinal (Thymic) Large B-Cell Lymphoma
thyroid gland anaplastic carcinoma squamous cell carcinoma pattern	Thyroid Gland Anaplastic Carcinoma Squamous Cell Carcinoma Pattern
endometrioid endomet adenocar final pathology  dx confirmed arising in the endometrium with invasion to myometrium tumor gradestage figo grade 2location of known metastases bilateral ovaries peritoneum posterior cul de sac small bowel nodule omentum gastric nodule	ENDOMETRIAL ENDOMETRIOID ADENOCARCINOMA
unknown	Kidney Cancer
krukenberg tumor	Krukenberg Tumor
metastatic adenocarcinoma	Biliary Tract Carcinoma
adenocarcinoma - colon per site notes patient diagnosed in 2011 with synchronous colon + rectal cancer recurrent disease	Colon Adenocarcinoma
rare cancers abdominal fibromatosis	Abdominal (Mesenteric) Fibromatosis
metastasis esophagus	ESOPHAGEAL CANCER
rare cancers adenocarcinoma	Small Intestinal Adenocarcinoma
anaplastic large cell lymphoma	ANAPLASTIC LARGE CELL LYMPHOMA
liporal cavity squam cell car final pathology 635 lymph nodes + for lymph-vascular and perineural invasion  tumor gradestage pt4an2b	LIP AND ORAL CAVITY SQUAMOUS CELL CARCINOMA
carcinosarcoma/malignant mullerian mixed tumor	MALIGNANT MIXED MESODERMAL (MULLERIAN) TUMOR
ovarian clear cell adenocarcinoma	OVARIAN CLEAR CELL ADENOCARCINOMA
ovarian carcinosarcoma	Ovarian Carcinosarcoma
mantle cell lymphoma	Mantle Cell Lymphoma
ductal	Breast Ductal Carcinoma
squamous cell lung carcinoma non-keratinizing epidermoid  final pathology dx confirmed, moderately differentiated with lymph-vascular invasion present tumor gradestage pt1b pn0 ajcc prognostic group staging histologic grade 2	LUNG SQUAMOUS CELL CARCINOMA
liporal cavity squam cell car tumor stagegrade pt4a pn1 grade 2, moderately differentiated	LIP AND ORAL CAVITY SQUAMOUS CELL CARCINOMA
inflammatory breast carcinoma tnbc tumor stagegrade pt3n2amx	Triple-Negative Breast Carcinoma
invasive breast carcinoma ductal, tnbc location of known metastases liver	Triple-Negative Breast Carcinoma
other tubulovillous adenoma	Colon Tubulovillous Adenoma
carcinoma	CARCINOMA
urothelialbladder cancer nos invasive papillary with sarcomatoid differentiation 52007 - bx proven adenocarcinoma of prostate42015 - underwent re-turp pathology positive high grade sarcoma tumor gradestage high-grade	BLADDER PAPILLARY UROTHELIAL CARCINOMA
metastasis breast	BREAST CANCER
renal cancer	Kidney Cancer
nsclc (nos)	Lung Non-Small Cell Carcinoma
squamous cell carcinoma	LUNG SQUAMOUS CELL CARCINOMA
adenocarcinoma	Lung Adenocarcinoma
pulmonary adenocarcinoma	Lung Adenocarcinoma
lip/oral cavity squam. cell car.	Lip and Oral Cavity Squamous Cell Carcinoma
adenocarcinoma - colon invasive moderately differentiated tumor gradestage t3n0m0 stage iia	COLON ADENOCARCINOMA
non-rhabdo soft tissue sarcoma pleomorphic	UNDIFFERENTIATED PLEOMORPHIC SARCOMA
pancreatic carcinoma	PANCREATIC CARCINOMA
cervical cancer, nos	Cervical Cancer
primary effusion lymphoma	PRIMARY EFFUSION LYMPHOMA
laryngeal squamous cell carcinoma recurrent disease	LARYNGEAL SQUAMOUS CELL CARCINOMA
hurthle cell neoplasm (thyroid)	Thyroid Gland Hurthle Cell Carcinoma
merkel cell carcinoma	Merkel Cell Carcinoma
urothelialbladder cancer nos papillary wextensive squamous differentiation  final pathology dx confirmed papillary exophytic and partially endophytic with extension through the bladder wall perivesical fat and into circumferential margin focally  tumor gradestage high-grade pt3a pn0 pnx	BLADDER PAPILLARY UROTHELIAL CARCINOMA
melanoma spindle cell type	CUTANEOUS MELANOMA
urothelialbladder cancer nos patient ho breast cancer 1997	Urinary System Cancer
ovary serous adenocarcinoma	Ovarian Serous Adenocarcinoma
neuroendocrine cancer, nos large cell neuroendocrine carcinoma of the lung final pathology dx confirmed small focus of non-mucinous adenocarcinoma in-situ present pathologic staging pt1b pn0	Lung Large Cell Neuroendocrine Carcinoma
h n squamous cell car nos tumor gradestage stage ivarecurrent disease at primary site	Head and Neck Squamous Cell Carcinoma
transitional cell carcinoma	BLADDER UROTHELIAL CARCINOMA
pleomorphic carcinoma	Lung Pleomorphic Carcinoma
adenocarcinoma - pancreas moderately differentiated wmucinous features final pathology dx confirmed with 5-10 of liver involved by metastasis tumor stagegrade grade ivlocation of known metastases lung multifocal liver carcinomatosis abdominal lymph nodes diaphragmconcurrent dx papillary rcc pax8+ ck7+ cd117- grade 1 and clear cell rcc pax8+ ck7- cd117-prior ho basel cell carcinoma and bladder cancer	PANCREATIC ADENOCARCINOMA
adenocarcinoma - colon final pathology dx confirmed, invasive through the muscularis propria tumor gradestage grade 2 moderately differentiated pt3 pn0primary tumor site rectosigmoid	Colon Adenocarcinoma
rare cancers clear cell sarcoma	Clear Cell Sarcoma of Soft Tissue
merkel cell carcinoma	MERKEL CELL CARCINOMA
adenocarcinoma - colon tumor gradestage t3n0m1a stage 4alocation of known metastases liver	COLON ADENOCARCINOMA
gastric adenosquamous carcinoma	Gastric Adenosquamous Carcinoma
cervix cancer	CERVICAL CANCER
b lymphoblastic leukemia/lymphoma with t(12;21)(p13.2;q22.1); etv6-runx1	B Lymphoblastic Leukemia/Lymphoma with t(12;21)(p13.2;q22.1); ETV6-RUNX1
adenocarcinoma - pancreas tumor gradestage grade 3location of known metastases liver pericolonic mass	PANCREATIC ADENOCARCINOMA
amelanotic melanoma	Amelanotic Cutaneous Melanoma
urothelialbladder cancer nos papillary bladder cancer final pathology dx confirmed high grade with invasion of the perivascular tissue tumor gradestage high grade	Bladder Papillar Urothelial Carcinoma
invasive lobular carcinoma	Invasive Lobular Breast Carcinoma
pancreatic cancer noninfiltrating intraductal papillary adenocarcinoma	Pancreatic Adenocarcinoma
adenocarcinoma - small intest location of known metastases liver	Small Intestinal Adenocarcinoma
other tubular adenoma	COLON CANCER
h & n squamous cell car., nos	HEAD AND NECK SQUAMOUS CELL CARCINOMA
adenocarcinoma	Esophageal Adenocarcinoma
mucinous cystadenocarcinoma	Mucinous Cystadenocarcinoma
breast adenocarcinoma	BREAST CARCINOMA
pancreatic cancer invasive adenocarcinoma arising from ipmn	Invasive Pancreatic Micropapillary Adenocarcinoma
mixed glioma	Mixed Glioma
adenocarcinoma - stomach invasive poorly differentiated	Gastric Adenocarcinoma
not collected	Intestinal Neoplasm
metastatic adenocarcinoma	Colon Adenocarcinoma
atypical adenorcarcinoma	lung adenocarcinoma
rare cancers papillary transitional cell carcinoma	Papillary Transitional Cell Carcinoma
kidney medullary carcinoma	Kidney Medullary Carcinoma
ductal carcinoma	DUCTAL BREAST CARCINOMA
childhood acute differentiated monocytic leukemia	Childhood Acute Monocytic Leukemia
pre-b all	B ACUTE LYMPHOBLASTIC LEUKEMIA
malig periph nerve sheath tum recurrence at primary site	MALIGNANT PERIPHERAL NERVE SHEATH TUMOR
adult acute myeloid leukemia	ACUTE MYELOID LEUKEMIA
fibrosarcoma - not infantile myxofibrosarcoma	FIBROSARCOMA
sacral chordoma	Sacral Chordoma
carcinoma: urothelial carcinoma	BLADDER UROTHELIAL CARCINOMA
ssm; ns; lm melanoma	CUTANEOUS MELANOMA
lung adenocarcinoma location of known metastasis chest wall arm	LUNG ADENOCARCINOMA
melanoma ho right parotid mass ho premalignant melanoma final pathology dx confirmed involving intaparotid lymph node extranodal extension indentified location of known metastases parotid gland	CUTANEOUS MELANOMA
invasive mammary ductal carcinoma	INVASIVE DUCTAL CARCINOMA NOT OTHERWISE SPECIFIED
invasive carcinoma	Colon Carcinoma
liporal cavity squam cell car final pathology tongue and floor of mouth, en bloc resection dx confirmed tumor stagegrade moderately-differentiated	Lip and Oral Cavity Squamous Cell Carcinoma
fibrosarcoma - not infantile low grade myxofibrosarcoma final pathology dx confirmed mitotic activity up to 7 per 10 hpf no tumor necrosis identified recurrent disease primary site multifocal loco-regional recurrence of left buttockfnclcc grade 13 low grade	Myxofibrosarcoma
urothelialbladder cancer nos adenocarcinoma bladder signet ring tumor stagegrade stage iv pt4n2m1 grade high	Bladder Signet Ring Cell Adenocarcinoma
adult acute monocytic leukemia	ACUTE MONOCYTIC LEUKEMIA
ovarian clear cell adenocarcinoma	Ovarian Clear Cell Adenocarcinoma
anal cancer	Anal Cancer
adenocarcinoma - colon location of known metastases shoulder	COLON ADENOCARCINOMA
pineoblastoma 4	PINEOBLASTOMA
metastasis prostate	PROSTATE CANCER
head and neck squamous cell carcinoma	Tonsillar Squamous Cell Carcinoma
lung adenocarcinoma mucinous	LUNG ADENOCARCINOMA
melanoma	Childhood Meningeal Melanoma
adenosquamous carcinoma	Extrahepatic Bile Duct Adenosquamous Carcinoma
myelodysplastic syndromes	MYELODYSPLASTIC SYNDROME
adenocarcinoma - colon mucinous final pathology dx confimed invasive into abdominal wall tumor gradestage pt4b pn0 low grade	Colon Mucinous Adenocarcinoma
lung adenocarcinoma tumor stagegrade stage iiib, pt3n1mx, grade 3	LUNG ADENOCARCINOMA
nodular; non-acral cutaneous melanoma	Cutaneous Melanoma
pleomorphic liposarcoma	Pleomorphic Liposarcoma
nsclc (caucasian, adenocarcinoma subtype)	Lung Non-Small Cell Carcinoma
adenocarcinoma - colon moderately differentiated	Colon Adenocarcinoma
blastic plasmacytoid dendritic cell neoplasm	BLASTIC PLASMACYTOID DENDRITIC CELL NEOPLASM
osteosarcoma giant rich cell ho neurofibrosarcomapath necrosis microscopic or macroscopic present, 70 tumor gradestage high grade pt1pnxrecurrent disease primary tumor site long bones of upper limb, scapula with cortical involvement, medullary cavity involvement and extension into soft tissue	Giant Cell-Rich Osteosarcoma
sarcoma	Bone Sarcoma
small cell lung cancer neuroendocrine tumor location of known metastasis lymph node	Lung Small Cell Carcinoma
sarcoma gist	GASTROINTESTINAL STROMAL TUMOR
squamous cell lung carcinoma final pathology dx confirmed with lymphovascular space invasion scc in situ focally present at bronchial margin known ho of asbestos exposure tumor gradestage pt2a pn0moderately differentiated	LUNG SQUAMOUS CELL CARCINOMA
transitional cell car - uroth recurrent disease	Urothelial Carcinoma
adult acute myeloid leukemia	Adult Acute Myeloid Leukemia
malig periph nerve sheath tum recurrence at primary site	Malignant Peripheral Nerve Sheath Tumor
adenocarcinoma - colon invasive	Colon Adenocarcinoma
rare cancers papillary adenocarcinoma	Thyroid Gland Papillary Carcinoma
large neuroendocrine carcinoma; t2an0mn/a	LUNG LARGE CELL NEUROENDOCRINE CARCINOMA
acute monocytic leukemia	Acute Monocytic Leukemia
adenocarcinoma - colon location of known metastases liver, intrahepatic bile duct, omentum	COLON ADENOCARCINOMA
adenocarcinoma - rectum invasive  final pathology dx confirmed lymphovascular space and perineural invasion are present three tumor deposits identified in pericolic fat 2 of 16 lymph nodes positive for tumor tumor gradestage moderately differentiatedlocation of known metastases pericolic fat lymph nodes	RECTAL ADENOCARCINOMA
ewing's sarcoma --	Ewing Sarcoma
high grade. carcinosarcoma with mixed heterologous (rhabdomyosarcoma) and homologous (undifferentiated sarcoma) differentiation.	Uterine Carcinosarcoma
squamous cell lung carcinoma moderately differentiated +perineural invasion 211 hilar ln positive	Lung Squamous Cell Carcinoma
melanoma vulvar tumor stagegrade poorly differentiated	Cutaneous Melanoma
marginal zone lymphoma	Marginal Zone Lymphoma
rhabdomyosarcoma	RHABDOMYOSARCOMA
lymphoma cns secondary	Central Nervous System Lymphoma
adenocarcinoma - pancreas known location of metastases lungtumor gradestage stage iv ajcc, grade 2	PANCREATIC ADENOCARCINOMA
appendix carcinoma	Appendix Carcinoma
adenocarcinoma - colon rectosigmoid recurrent disease	COLON ADENOCARCINOMA
pancreatic carcinoma - infiltrating ductal adenocarcinoma (idac)	Pancreatic Ductal Adenocarcinoma
non-rhabdo soft tissue sarcoma undifferentiated pleomorphic sarcoma patient was registered as non-rhabdo soft tissue sarcoma high grade with spindle cell features pdx pathology review with ihc revised to undifferentiated pleomorphic sarcoma recurrent disease primary site	UNDIFFERENTIATED PLEOMORPHIC SARCOMA
malignant biphasic mesothelioma	Pleural Biphasic Mesothelioma
sarcoma radiation therapy induced osteosarcoma; 2nd isolation from same patient as shim1	Osteosarcoma
ewing's sarcoma --	Metastatic Ewing Sarcoma
not collected	Kidney Neoplasm
lung squamous cell carcinoma, basaloid	LUNG SQUAMOUS CELL CARCINOMA
serous adenocarcinoma	OVARIAN SEROUS ADENOCARCINOMA
urothelialbladder cancer nos  papillary location of known metastases kidney bowel and bladdertumor stagegrade high grade	BLADDER PAPILLARY UROTHELIAL CARCINOMA
metastasis uterine	Uterine Cancer
adenocarcinoma - pancreas mucinous final pathology dx confirmed with extensive perineural invasion less than 1 of liver volume involved in metastasis tumor gradestage grade iv aypt4 aypn1 aypm1 ajcc pathologic staging, moderately differentiatedlocation of known metastases liver, diaphragm, mesentery, omentum, adrenal glands, bilateral lungs, rectal soft tissue and muscularis propria, appendix, serosal soft tissue of the esophagus, lymph nodes regional and distant	Pancreatic Adenocarcinoma
stomach cancer invasive adenocarcinoma with conventional and enteroblastic differentiation	Gastric Adenocarcinoma
adenocarcinoma - small intest location of primary tumor duodenumlocation of distant metastases peritoneum	Small Intestinal Adenocarcinoma
glioma	Malignant Glioma
pancreatic carcinoma - intraductal papillary mucinous neoplasm with nvasive carcinoma	Pancreatic Intraductal Papillary-Mucinous Neoplasm with an Associated Invasive Carcinoma
malignant fibrous histiocytoma undifferentiated pleomorphic  final path high grade with myxoid features	UNDIFFERENTIATED PLEOMORPHIC SARCOMA
ductal carcinoma	Pancreatic Ductal Adenocarcinoma
liporal cavity squam cell car moderately differentiated final pathology moderately differentiated scc confirmed with greater than half ln positive location of know metastases lymph nodes	Lip and Oral Cavity Squamous Cell Carcinoma
rectal mucinous adenocarcinoma	Rectal Mucinous Adenocarcinoma
uterine sarcoma leiomyosarcoma	Uterine Corpus Leiomyosarcoma
wilms tumor favorable	Kidney Wilms Tumor
adenocarcinoma - colon recurrent diseaselocation of known metastases liver	Colon Adenocarcinoma
metastatic adenocarcinoma	Esophageal Adenocarcinoma
malignant fibrous histiocytoma pleomorphic tumor stagegrade undifferentiated recurrent disease at primary site soft tissue mass in thighhigh-grade	UNDIFFERENTIATED PLEOMORPHIC SARCOMA
adenocarcinoma - colon neuroendocrine features final pathology dx confirmed wneuroendocrine features on he invasive into pericolonic soft tissue, 516 lymph nodes positive for metastatic disease tumor gradestage poorly differentiated iiiblocation of known metastases liver, lung, lymph nodes	COLON ADENOCARCINOMA
laryngeal squamous cell carcinoma	LARYNGEAL SQUAMOUS CELL CARCINOMA
urothelialbladder cancer nos invasive papillary with sarcomatoid differentiation 52007 - bx proven adenocarcinoma of prostate42015 - underwent re-turp pathology positive high grade sarcoma tumor gradestage high-grade	Bladder Papillary Urothelial Carcinoma
metastatic adenocarcinoma	COLON ADENOCARCINOMA
lung squamous cell carcinoma	LUNG SQUAMOUS CELL CARCINOMA
urothelial carcinoma	Bladder Urothelial Carcinoma
pharyngeal squam cell carcinoma location of primary tumor base of tongue lingual epiglottis	Pharyngeal Squamous Cell Carcinoma
cutaneous malignant melanoma	CUTANEOUS MELANOMA
adenocarcinoma	Cecum Adenocarcinoma
melanoma final pathology report dx confirmed with desmoplastic features mitotic activity is noted in the tumor 2mm2 necrosis is focally present involving approximately 20 of the specimen  recurrent disease primary site	CUTANEOUS MELANOMA
glioblastoma multiforme proneural	GLIOBLASTOMA
liposarcoma dedifferentiated	Dedifferentiated Liposarcoma
ovarian cancer, nos	OVARIAN CANCER
large cell neuroendocrine carcinoma	Lung Large Cell Neuroendocrine Carcinoma
ovarian epithelial cancer serous carcinoma final pathology dx confirmed uterus with multiple myometrial and subserosal foci ovarian cortical invasion complete transmural invasion of colonic wall lymph node in parametrial soft tissue ovarian primary tumor stage pt3c pnxlocation of known metastases omentum, fallopian fimbria, parametrial soft tissue, rectosigmoid colon, colonic mesentery, gastric nodule	OVARIAN SEROUS ADENOCARCINOMA
non-rhabdo soft tissue sarcoma spindle cell sarcoma  25 viable tumor with 75 necrosis final pathology dx confirmed with myxoid stroma present  tumor gradestage grade 3 of 3 fnclcc high grade pt4n0 undifferentiated	Soft Tissue Sarcoma
rcc clear cell adenocarcinoma grade 4	CLEAR CELL RENAL CELL CARCINOMA
nhl, nos b-cell final hematopathology dx confirmed ihc differential diagnosis to include follicular lymphoma, dlbcl, and burkitt lymphomaflow cytometry 97 b-cell, 025 t-cell fish impression abnormal for rearrangement of bcl6 locus at 3q27 in 95 of cells and rearrangement of ighbcl2 in 97 of cells fish karyotypen200 nuc ish 3q275bcl6x24,3bcl6x235bcl6 con 3bcl6x12190200 nuc ish 14q32ighx02,18q21bcl2x12igh con bcl2x23194200 nuc ish 8q24mycx2200	Anaplastic Large Cell Lymphoma
b/myeloid all	MIXED PHENOTYPE ACUTE LEUKEMIA
squamous cell carcinoma	Anal Canal Squamous Cell Carcinoma
nsclc (caucasian adenocarcinoma subtype)	LUNG NON-SMALL CELL CARCINOMA
hairy cell leukemia	HAIRY CELL LEUKEMIA
childhood acute myeloid leukemia not otherwise specified	Childhood Acute Myeloid Leukemia Not Otherwise Specified
malignant fibrous histiocytoma undifferentiated pleomorphic final pathology dx confirmed high-grade tumor present in subcutaneous tissue focally infiltrates skeletal muscle and tendon mitotic index 310 hpf 5 tumor necrosis tumor gradestage iib ct2bn0m0	UNDIFFERENTIATED PLEOMORPHIC SARCOMA
non-rhabdo soft tissue sarcoma mesenchymal tumor compatible with myxofibrosarcoma final pathology dx confirmed locally invasive and infiltrative to muscle adipose and surrounding glandular tissue   fnclcc grade 2 of 3	MYXOFIBROSARCOMA
carcinoma	Lung Carcinoma
squamous cell lung carcinoma moderately differentiated final pathology dx confirmed squamous cell papilloma with foci of invasive squamous cell carcinoma tumor gradestage grade 2 pt1a pn0	LUNG SQUAMOUS CELL CARCINOMA
adenocarcinoma - colon per site notes, patient diagnosed in 2011 with synchronous colon + rectal cancer recurrent disease	Colon Adenocarcinoma
stomach cancer signet ring cell carcinoma	Gastric Signet Ring Cell Adenocarcinoma
moderate to poorly differentiated squamous cell carcinoma (3.0 cm in maximal dimension)	Lung Squamous Cell Carcinoma
h n squamous cell car nos keratinizing	Keratinizing Head and Neck Squamous Cell Carcinoma
mesothelioma epithelial type	Epithelioid Mesothelioma
liporal cavity squam cell car cutaneous signet-ring	Lip and Oral Cavity Squamous Cell Carcinoma
well differentiated adenocarcinoma	lung adenocarcinoma
adenocarcinoma - colon location of known metastases liver intrahepatic bile duct omentum	Colon Adenocarcinoma
colorectal cancer	COLORECTAL CANCER
stomach cancer tubular (intestinal) adenocarcinoma	Gastric Tubular Adenocarcinoma
malignant mixed mesodermal (mullerian) tumor	Malignant Mixed Mesodermal (Mullerian) Tumor
fibrosarcoma - not infantile myxofibrosarcoma  final pathology dx confirmed tumor gradestage high grade	MYXOFIBROSARCOMA
rhabdomyosarcoma, nos adult type pleomorphic multifocal lymphovascular invasion tumor gradestage grade 3 location of known metastases lymph nodes	Adult Pleomorphic Rhabdomyosarcoma
malignant fibrous histiocytoma final pathology dx confirmed	Undifferentiated Pleomorphic Sarcoma
liporal cavity squam cell car invasive keratinizing addl medical hx extensive history of betel nut use 20yrs	LIP AND ORAL CAVITY SQUAMOUS CELL CARCINOMA
adenocarcinoma - rectum primary tumor location arising in a tubulovillus adenomalocation of known metastases liver, lungtumor gradestage stage iiia, moderately differentiated recurrence at primary site	RECTAL ADENOCARCINOMA
carcinoma	Breast Carcinoma
carcinosarcoma	Uterine Carcinosarcoma
adenocarcinoma	Cervical Adenocarcinoma
lung cancer small cell carcinoma	Lung Small Cell Carcinoma
floor of mouth squamous cell carcinoma	Floor of Mouth Squamous Cell Carcinoma
small intestine carcinoid neuroendocrine tumor	Small Intestinal Neuroendocrine Tumor G1
juvenile myelomonocytic leukemia	Juvenile Myelomonocytic Leukemia
colorectal cancer adenocarcinoma, intestinal type	Colorectal Adenocarcinoma
adenocarcinoma nos location of primary tumor unknown	Adenocarcinoma
adenocarcinoma - pancreas pathology pancreas tail, adenomasquamous pancreas head, adenocarcinoma tumor gradestage ajcc iv, pt3n1mx, grade 2	PANCREATIC ADENOCARCINOMA
colon cancer (caucasian europe)	COLON CANCER
testicular teratoma	Testicular Teratoma with Somatic-Type Malignancy
leiomyosarcoma - not uterine final path dx confirmed grade 3	Leiomyosarcoma
melanoma location of known metastases adrenals axillary lymph nodeslocation of primary tumor back skin	Cutaneous Melanoma
adenocarcinoma - pancreas ductal final pathology dx confirmed unresectable primary tumor due to major blood vessel involvement positive perineural invasion tumor gradestage iv moderately differentiatedlocation of known metastases liver 5primary tumor location pancreatic head	Pancreatic Adenocarcinoma
rare cancers transitional cell carcinoma	Bladder Urothelial Carcinoma
therapy-related acute myeloid leukemia	Therapy-Related Acute Myeloid Leukemia
adenocarcinoma - pancreas ductal final pathology dx confirmed with peripancreatic soft tissue invasion and lymphovascular and perinueral invasion 422 lymph nodes + location of known metastases lymph nodestumor gradestage pt3pn1 stage iib ajcc	Pancreatic Ductal Adenocarcinoma
lung mucoepidermoid carcinoma	Lung Mucoepidermoid Carcinoma
upper tract urothelial carcinoma	Urothelial Carcinoma
lung large cell	Lung Large Cell Carcinoma
precursor t lymphoblastic leukemia	T Lymphoblastic Leukemia/Lymphoma
liporal cavity squam cell car poorly differentiated primary location of tumor tonguetumor gradestage pt2n0	ORAL CAVITY SQUAMOUS CELL CARCINOMA
squamous cell lung carcinoma invasive moderately differentiated  extensive history of cancer and cancer-related mortality among primary relativesfinal pathology dx confirmed	LUNG SQUAMOUS CELL CARCINOMA
embryonal carcinoma	Embryonal Carcinoma
head and neck squamous cell carcinoma	Supraglottic Squamous Cell Carcinoma
metastasis intestine	Colon Cancer
moderately to poorly differentiated pancreatic ductal adenocarcinoma	Pancreatic Ductal Adenocarcinoma
ovarian epithelial cancer serous adenocarcinoma final pathology dx confirmed bilateral ovariesho medullary carcinoma of the breast no systemic treatment given tumor gradestage high-gradelocation of known metastases fallopian tube left peritoneum uterus myometrium peritoneum posterior cul-de-sac	Ovarian Serous Adenocarcinoma
breast cancer pleomorphic carcinoma	Breast Pleomorphic Carcinoma
ns melanoma	Melanoma
uterine cancer nos invasive clear cell carcinoma for the endometrium final pathology dx confirmed 18 of 28 pelvic and peri-aortic nodes positive for disease extranodal extension present invasive through 100 of myometrium extensive lymphovascular invasion identified as well as extensive necrosis in the uterine portionfamily history of breast cancer and uterine leiomyosarcoma tumor gradestage pt3a pn2location of known metastases bilateral ovaries lymph nodes	Uterine Cancer
squamous cell breast carcinoma acantholytic variant	Breast Squamous Cell Carcinoma Acantholytic Variant
well differentiated liposarcoma	Liposarcoma
femaleollicular lymphoma	FOLLICULAR LYMPHOMA
cancer	Colon Carcinoma
small cell car extrapulmonary small cell cancer of the bladder primary diagnosis urothelialbladder cancer nos patient was registered as urothelialbladder cancer nos pdx pathology review changed diagnosis of model to small cell cancer of the bladder extrapulmonary the diagnosis was reclassified	Bladder Small Cell Carcinoma
sarcoma synovial sarcoma	SYNOVIAL SARCOMA
acute promyelocytic leukemia	Adult Acute Promyelocytic Leukemia with PML-RARA
squamous cell carcinoma - skin foci of keratinization ho scc at scalp and neck, treated with surgical excision recurrent scc 62014 at scalp again surgically excised recurrent diseasetumor stagegrade poorly differentiated	SKIN SQUAMOUS CELL CARCINOMA
bone osteosarcoma	BONE OSTEOSARCOMA
rare cancers adenocarcinoma, intestinal type	Bladder Adenocarcinoma
colorectal cancer other	Colorectal Cancer
acute promyelocytic leukemia	Acute Promyelocytic Leukemia with PML_and_RARA
not collected	Breast Neoplasm
salivary gland cancer mucoepidermoid carcinoma recurrent disease	Salivary Gland Mucoepidermoid Carcinoma
adenocarcinoma - colon final pathology dx confirmed, with tumor budding invasive to but not through muscularis propria extramural venous and perineural invasion present tumor gradestage low-grade pt2 n0 ajcc classification 7th edition	COLON ADENOCARCINOMA
lung carcinoma	LUNG CARCINOMA
t-cell prolymphocytic leukemia	T-Cell Prolymphocytic Leukemia
ipmn, non invasive	Pancreatic Intraductal Papillary_and_Mucinous Neoplasm
adenocarcinoma - pancreas prior malignancy renal cell carcinoma ctep sdc code 10038415 no therapy administered, treated surgically only tumor gradestage fuhrman grade i	PANCREATIC ADENOCARCINOMA
lung squamous carcinoma	Lung Squamous Cell Carcinoma
rhabdoid tumor	Rhabdoid Tumor
ovarian epithelial cancer clear cell  location of known metastases peritoneum	Malignant Ovarian Clear Cell Tumor
vulvar cancer nos invasive moderately differentiated squamous cell carcinoma	Vaginal Squamous Cell Carcinoma Not Otherwise Specified
colorectal carcinoma	COLORECTAL CARCINOMA
mucinous gastric adenocarcinoma	Gastric Mucinous Adenocarcinoma
rcc clear cell adenocarcinoma final pathology dx confirmed tumor invades into renal vein 126 lymph nodes adjacent to tumor involved by direct extension tumor gradestage fuhrman grade iii	Clear Cell Renal Cell Carcinoma
adenocarcinoma	LIVER AND INTRAHEPATIC BILE DUCT CARCINOMA
neuroendocrine cancer, nos carcinoma final pathology neuroendocrine, nos favoring carcinoma of gi origin location of known metastases liver, lymph nodestumor stagegrade poorly differentiated	Neuroendocrine Carcinoma
lung combined adenocarcinoma (90%) and large cell neuroendocrine carcinoma (10%)	LUNG ADENOCARCINOMA
head and neck cancer: pharynx squamous cell carcinoma	Head and Neck Squamous Cell Carcinoma
endometrial cancer mixed cell carcinoma	Endometrial Carcinoma
adult t-cell leukemia/lymphoma	Adult T-Cell Leukemia/Lymphoma
salivary gland cancer adenoid cystic carcinoma  final pathology dx confirmed with high-grade transformationdedifferentiated hpv- tumor gradestage t4bn0m0	Adenoid Cystic Carcinoma
gastrointestinal stromal tumor history of low-grade papillary urothelial carcinoma 1year prior tumor gradestage high grade t4nxm1	GASTROINTESTINAL STROMAL TUMOR
upper tract urothelial carcinoma	Regional Renal Pelvis and Ureter Urothelial Carcinoma
metastatic adenocarcinoma	Lung Adenocarcinoma
metastatic sarcoma; unknown subtype	Sarcoma
adenocarcinoma - colon moderately differentiated location of primary disease sigmoid colon	Colon Adenocarcinoma
neuroendocrine cancer nos poorly differentiated large cell neuroendocrine carcinoma lcnc of the ovary  final patient pathology dx confirmed lymphovascular invasion present uterus with some evidence of unequivocal endometrioid adenocarcinoma figo grade 1 extensive tumor involvement of all reproductive organs pelvic wall and omentum  tumor gradestage figo grade 2 pt3a pn1a pm1 figo stage ivb	Ovarian Large Cell Neuroendocrine Carcinoma
double-hit non-hodgkin lymphoma	Aggressive Non-Hodgkin Lymphoma
mucinous adenocarcinoma	Colon Mucinous Adenocarcinoma
adenocarcinoma - cervix pdx review of patient material confirms non-keratinizing squamous cell carcinoma with features of transitional cells location of known metastasis liver	Cervical Adenocarcinoma
transitional cell car - uroth papillary	Urothelial Carcinoma
cutaneous melanoma	Cutaneous Melanoma
gastrointestinal cancer, nos	Appendix Cancer
lung cancer invasive adenocarcinoma, acinar predominant	Lung Acinar Adenocarcinoma
h n squamous cell car, nos scc of the maxillary sinus tumor stagegrade pt3n0m0 invasive moderately differentiated	Head and Neck Squamous Cell Carcinoma
non-rhabdo soft tissue sarcoma pleomorphic tumor stagegrade undifferentiated	UNDIFFERENTIATED PLEOMORPHIC SARCOMA
squamous cell carcinoma	Tonsillar Squamous Cell Carcinoma
human papilloma virus-related cervical squamous cell carcinoma	Human Papillomavirus-Related Cervical Squamous Cell Carcinoma
adenocarcinoma	Ovarian Adenocarcinoma
rare cancers mucinous adenocarcinoma	Appendix Mucinous Adenocarcinoma
precursor lymphoblastic lymphoma	Lymphoblastic Lymphoma
undifferentiated round cell sarcoma	Undifferentiated Round Cell Sarcoma
skin squamous cell carcinoma	Skin Squamous Cell Carcinoma
colorectal cancer nos	colorectal cancer
kidney cancer chromophobe renal cell carcinoma	Chromophobe Renal Cell Carcinoma
adenocarcinoma - colon patient has 30 year history of chewing tobacco use recurrent disease primary sitelocation of known metastases liver	COLON ADENOCARCINOMA
adenocarcinoma - colon adrenal mass was unresponsive to study agents all other sites of disease lung and liver initially responded location of known metastases liver lung adrenal gland bone	COLON ADENOCARCINOMA
cervical adenocarcinoma	Cervical Adenocarcinoma
adenocarcinoma - rectum moderately differentiated  primary tumor location arising in a tubulovillus adenomalocation of known metastases liver lungtumor gradestage stage iiiarecurrence at primary site	RECTAL ADENOCARCINOMA
large-cell carcinoma	Lung Large Cell Carcinoma
adenocarcinoma	Bile Duct Adenocarcinoma
gastrointestinal cancer, nos appendiceal	Appendix Cancer
adenocarcinoma - colon poorly differentiated final pathology dx confirmed lymphatic invasion present tumor gradestage tnbm0	Colon Adenocarcinoma
pharyngeal squam cell carcinoma final pathology dx confirmed, p16+ extensive lymphovascular invasion identified  4 of 30 lymph nodes positive at levels 2a and 3ho adenocarcinoma of the distal esophagus - t4n1m1a, stage iv a in 2007 tumor stagegrade moderate to poorly differentiatedlocation of known metastases lymph nodes	PHARYNGEAL SQUAMOUS CELL CARCINOMA
adenocarcinoma - rectum intramucosal tumor stagegrade ut3 n1 m0concurrent dx lung adenocarcinoma ctep sdc code 10025032 no prior treatment received	Rectal Adenocarcinoma
ovarian cystadenocarcinoma	OVARIAN CYSTADENOCARCINOMA
osteosarcoma --	Osteosarcoma
cholangiocar- intraextrahepatic prior malignancy cervical cancer ctep sdc code 10008238 tumor gradestage pt2a nx cm0	Cholangiocarcinoma
nodular; ns; mis; ssm melanoma	CUTANEOUS MELANOMA
metaplastic carcinoma; nos	Metaplastic Breast Carcinoma
ovarian cancer mucinous borderline tumor/atypical proliferative mucinous tumor	Borderline Ovarian Mucinous Tumor_and_Atypical Proliferative Ovarian Mucinous Tumor
cutaneous nodular malignant melanoma	Cutaneous Nodular Melanoma
mullerian mixed tumour	Malignant Mixed Mesodermal (Mullerian) Tumor
urothelialbladder cancer nos sarcomatoid transitional cell ca past history breast ca 2000family history 1st degree relative bladder cancer tumor stagegrade t2n2	Bladder Cancer
t lymphoblastic lymphoma	T Lymphoblastic Lymphoma
rcc clear cell adenocarcinoma tumor gradestage fuhrman nuclear grade 4	CLEAR CELL RENAL CELL CARCINOMA
lung squamous cell carcinoma, basaloid 	LUNG SQUAMOUS CELL CARCINOMA
neuroblastoma unfavorable	Adrenal Gland Neuroblastoma
nasopharyngeal differentiated carcinoma	Nasopharyngeal Differentiated Carcinoma
pharyngeal squam cell carcinoma oropharyngeal  patient with history of extensive surgical resections for recurrent disease at primary site recurrent disease	OROPHARYNGEAL SQUAMOUS CELL CARCINOMA
necrotic tumor and inflammatory cells	Kidney Cancer
metastasis liver	HEPATOBILIARY CANCER
adenocarcinoma - colon invasive  location of known metastases livertumor stagegrade poorly differentiated	COLON ADENOCARCINOMA
large cell	Lung Large Cell Carcinoma
philadelphia chromosome positive acute lymphoblastic leukemia	ACUTE LYMPHOBLASTIC LEUKEMIA
colon cancer (asian)	COLON CANCER
carcinosarcoma of the uterus prior malignancy basal cell skin cancer ctep sdc 10004146 tumor stagegrade pt1a pn0 figo 1a	UTERINE CARCINOSARCOMA
adenocarcinoma - pancreas carcinoma wrhabdoid features final pathology dx confirmed, poorly to undifferentiated carcinoma wrhabdoid features wextensive arterial vascular involvement in the pancreas, well-defined gland formation is absent and there are prominent areas of necrosis high-grade panin is noted within the pancreassmoking hx prior smoker, documentation did not quantify tumor gradestage iv, undifferentiatedprimary tumor location pancreas headlocation of known metastases liver 30, omentum, small large bowel, regional lymph nodes, and spleen	PANCREATIC ADENOCARCINOMA
clear cell adenocarcinoma	Ovarian Clear Cell Adenocarcinoma
cervical squamous cell carcinoma	CERVICAL SQUAMOUS CELL CARCINOMA NOT OTHERWISE SPECIFIED
urinary bladder cancer	BLADDER CANCER
acute leukemia of ambiguous lineage	Acute Leukemia of Ambiguous Lineage
adenocarcinoma - rectum location of known metastases liver	Rectal Adenocarcinoma
primary peritoneal carcinoma adenocarcinoma mullerian origin ho breast cancer, mastectomyfinal pathology hysterectomy and bilateral salpingo-oophorectomy bilateral fallopian tubes, bilateral ovaries and myometrium high grade serous carcinoma with invasion of the outer myometrium	Primary Peritoneal Adenocarcinoma
philadelphia chromosome positive acute lymphoblastic leukemia	Acute Lymphoblastic Leukemia
adenocarcinoma - pancreas ductal final pathology dx confirmed with peripancreatic soft tissue invasion, and lymphovascular and perinueral invasion 422 lymph nodes + location of known metastases lymph nodestumor gradestage pt3pn1 stage iib ajcc	PANCREATIC DUCTAL ADENOCARCINOMA
urothelialbladder cancer, nos papillary final pathologykidney and ureter, left, abdominal nephroureterectomy dx confirmedhistory of cis of the bladder 32011 treated only with surgery tumor gradestage low grade	Bladder Papillary Urothelial Carcinoma
adenocarcinoma - colon location of primary disease sigmoid colontumor stagegrademoderately differentiated	COLON ADENOCARCINOMA
ovarian epithelial cancer clear cell carcinoma final pathology dx confirmed left pelvic lymph node positive for metastatic disease 11 focal extracapsular extension identified	OVARIAN CARCINOMA
adenocarcinoma - colon final pathology dx confirmed lymphatic invasion present tumor gradestage tnbm0 poorly differentiated	COLON ADENOCARCINOMA
ovarian adenocarcinoma	OVARIAN ADENOCARCINOMA
fibrosarcoma - not infantile tumor gradestage intermediate grade	Fibrosarcoma
adenocarcinoma - colon invasive location of known metastases liver	COLON ADENOCARCINOMA
hepatocellular carcinoma trabecular and micro-acinar cells variant	Hepatocellular Carcinoma
heptocellular carcinoma	Hepatocellular Carcinoma
h n squamous cell car nos invasive moderately differentiated final pathology tongue right - dx confirmed lymphovascular space invasion identified 212 lymph nodes at right neck levels 2 and 3 location of known metastases lymph node	Tongue Squamous Cell Carcinoma
carcinosarcoma ovarian cancer	OVARIAN CARCINOSARCOMA
glioblastoma nos4	Brain Glioblastoma
adenocarcinoma	Anal Adenocarcinoma
prostate cancer, nos	Prostate Cancer
adenocarcinoma - pancreas final pathology dx confirmed smoking history known extensive exposure to second hand smoke tumor gradestage well-differentiated stage ivprimary tumor site pancreatic headlocation of known metastases liver 30 involved diaphragm omentum peritoneal carincomatosisconcurrentprior malignancy incidental finding of carcinoid tumorlet in lung prior history of ovarian carcinoma	PANCREATIC ADENOCARCINOMA
ovarian mucinous adenocarcinoma	Ovarian Mucinous Adenocarcinoma
malignant fibrous histiocytoma pleomorphic final pathology dx confirmed high-grade tumor present in subcutaneous tissue, focally infiltrates skeletal muscle and tendon mitotic index 310 hpf 5 tumor necrosis tumor gradestage iib ct2bn0m0, undifferentiated	Undifferentiated Pleomorphic Sarcoma
ovarian cancer, nos carcinosarcoma malignant mixed mullerian tumor	Malignant Mixed Mesodermal (Mullerian) Tumor
squamous cell carcinoma - skin poorly differentiated with foci of keratinization ho scc at scalp and neck treated with surgical excision recurrent scc 62014 at scalp again surgically excised recurrent disease	Skin Squamous Cell Carcinoma
endometrial cancer endometrioid carcinoma with squamous differentiation	Endometrial Carcinoma
gastrointestinal stromal tumor history of low-grade papillary urothelial carcinoma 1year prior tumor gradestage high grade t4nxm1	Gastrointestinal Stromal Tumor
metastatic adenocarcinoma	LUNG ADENOCARCINOMA
small cell car extrapulmonary small cell cancer of the bladder patient originally enrolled with urothelialbladder cancer nos review of pdx histology resulted in a change in diagnosis	Bladder Small Cell Carcinoma
head and neck squamous cell carcinoma	Floor of Mouth Squamous Cell Carcinoma
ewing sarcoma	Ewing Sarcoma of Bone
other sessile serrated adenoma	Serrated Lesions and Polyps
adenocarcinoma - rectum well differentiated pathology dx confirmed tumor stage t3n0m1a location of primary disease sigmoid and rectumlocation of known metastases liver	Rectal Adenocarcinoma
papillary lung adenocarcinoma	Lung Papillary Adenocarcinoma
soft tissue neoplasm, nos round cell sarcoma, cic-rearranged final pathology dx confirmed mitotic rate 4010 hpf necrosis is present, extensive  tumor staging pathological pt2pnxpmx, grade 3 fnclcc	Undifferentiated Round Cell Sarcoma
lung cancer	Lung Cancer
lung carcinoid tumor	LUNG CARCINOID TUMOR
liporal cavity squam cell car moderately-differentiated final pathology tongue and floor of mouth en bloc resection dx confirmed	Oral Cavity Squamous Cell Carcinoma
adenocarcinoma - rectum well-differentiated pathology dx confirmed tumor stage t3n0m1a location of primary disease sigmoid and rectumlocation of known metastases liver	RECTAL ADENOCARCINOMA
wilms tumor unfavorable	Kidney Wilms Tumor
endometrial cancer endometrioid carcinoma, nos	Endometrial Carcinoma
lung adenocarcinoma prior history of lymphoma	Lung Adenocarcinoma
leukemia (aml)	ACUTE MYELOID LEUKEMIA
adenocarcinoma - colon tumor gradestage t3n2mx	COLON ADENOCARCINOMA
ampulla of vater cancer neuroendocrine carcinoma, large cell	Ampulla of Vater Carcinoma
epithelioid mesothelioma	PLEURAL EPITHELIOID MESOTHELIOMA
osteosarcoma --	Bone Osteosarcoma
malignant fibrous histiocytoma pleomorphic  final path high grade with myxoid features  tumor stagegrade undifferentiated	UNDIFFERENTIATED PLEOMORPHIC SARCOMA
not specified	Lung Cancer
colorectal cancer nos invasive adenocarcinoma location of known metastases liver	Colon Adenocarcinoma
transitional cell car - uroth squamous cell ho breast cancerturbt 2014 confirmed muscular invasionfinal pathology dx confirmed with perineural extra-vesical and lymphovascular invasion  tumor stagegradepoorly differentiated	UROTHELIAL CARCINOMA
carcinoma	Kidney Carcinoma
metaplastic carcinoma; triple neg	METAPLASTIC BREAST CARCINOMA
leukemia	Leukemia
tongue squamous cell carcinoma	TONGUE SQUAMOUS CELL CARCINOMA
liporal cavity squam cell car	Lip and Oral Cavity Squamous Cell Carcinoma
unknown	PANCREATIC CANCER
lung adenocarcinoma poorly differentiated location of known metastases scalprecurrent disease distant metastasis	Lung Adenocarcinoma
liporal cavity squam cell car moderately differentiated final pathology dx confirmed +432 lymph nodes tumor gradestage pt2n2b	LIP AND ORAL CAVITY SQUAMOUS CELL CARCINOMA
leiomyosarcoma - not uterine final path dx confirmed grade 3	LEIOMYOSARCOMA
adenocarcinoma - colon mucinous moderately differentiated	Colon Mucinous Adenocarcinoma
high grade. carcinosarcoma, with mixed heterologous (rhabdomyosarcoma) and homologous (undifferentiated sarcoma) differentiation.	Uterine Carcinosarcoma
testicular teratoma	Testicular Teratoma
lung typical carcinoid	Lung Typical Carcinoid Tumor
acute leukemia	Acute Leukemia
high grade mixed epithelial type carcinoma, serous carcinoma and clear cell carcinoma, t1an0mx	Ovarian Carcinoma
melanoma recurrent diseaseprimary tumor stagegrade iia t3an0m0, current stage iiic	CUTANEOUS MELANOMA
small cell car extrapulmonary colon origin patient was registered as adenocarcinoma - colon invasion through the muscularis propria present patient was registered as adenocarcinoma - colon the pdx pathology confirms that the cells that grew out were from a small cell neuroendocrine carcinoma of the colon the diagnosis was reclassified	Colon Small Cell Neuroendocrine Carcinoma
ovarian cancer clear cell carcinoma	OVARIAN CLEAR CELL ADENOCARCINOMA
adenocarcinoma - stomach moderately differentiated adenocarcinoma - intestinal type	Gastric Adenocarcinoma
uterine cancer nos clear cell carcinoma	Endometrial Clear Cell Adenocarcinoma
ductal carcinoma	PANCREATIC DUCTAL ADENOCARCINOMA
malignant fibrous histiocytoma pleomorphic sarcoma recurrent disease localtumor gradestage fnclcc grade 3, undifferentiated	UNDIFFERENTIATED PLEOMORPHIC SARCOMA
malignant fibrous histiocytoma myxofibrosarcoma	Undifferentiated Pleomorphic Sarcoma
metastasis yolk sac tumor	YOLK SAC TUMOR
fibrosarcoma - not infantile myxofibrosarcoma final pathology dx confirmed mitotic activity up to 7 per 10 hpf no tumor necrosis identified recurrent disease primary site multifocal loco-regional recurrence of left buttockfnclcc grade 13, low grade	Myxofibrosarcoma
fibrosarcoma	Childhood Fibrosarcoma
acral melanoma	Acral Lentiginous Melanoma
t acute lymphoblastic leukemia	T ACUTE LYMPHOBLASTIC LEUKEMIA
breast cancer lobular carcinoma	Lobular Breast Carcinoma
adenocarcinoma - pancreas tumor composes 90 of the liver tumor gradestage moderately differentiated stage ivlocation of known metastases omentum liver lungs diaphragm kidney left vertebral body lymph nodes peri-aortic -gastric -pancreatic ascites	PANCREATIC ADENOCARCINOMA
squamous cell carcinoma - skin poorly differentiated with foci of keratinization ho scc at scalp and neck treated with surgical excision recurrent scc 62014 at scalp again surgically excised recurrent disease	SKIN SQUAMOUS CELL CARCINOMA
adenocarcinoma - pancreas invasive ductal  final pathology dx confirmed with focal mucinous and signet ring cell features positive extrapancreatic extension, lymphovascular and perineural invasion pancreatic neck margin is positive 218 lymph nodes positive tumor stage pt3n1 ajcc, 7th ed, 2010, moderately-poorly differentiated	PANCREATIC DUCTAL ADENOCARCINOMA
childhood acute myeloid leukemia	ACUTE MYELOID LEUKEMIA
female reproductive endometrioid cancer	ENDOMETRIOID TUMOR
epithelioid sarcoma	Epithelioid Sarcoma
adult acute monocytic leukemia	Adult Acute Monocytic Leukemia
adenocarcinoma - pancreas final pathology dx confirmed tumor gradestage pt3n1mx	PANCREATIC ADENOCARCINOMA
carcinosarcoma of the uterus mixed malignant mullerian tumor recurrent diseaselocation of metastases colon	Uterine Carcinosarcoma
uveal melanoma	uveal melanoma
liporal cavity squam cell car keratinizing type tumor stagegrade poorly differentiated	Lip and Oral Cavity Squamous Cell Carcinoma
not provided	Colon Cancer
rare cancers carcinoma of unknown primary	Carcinoma of Unknown Primary
neuroblastoma	PERIPHERAL NEUROBLASTOMA
lymphoma cns secondary	CENTRAL NERVOUS SYSTEM LYMPHOMA
epithelioid cell type gastrointestinal stromal tumor	Epithelioid Cell Type Gastrointestinal Stromal Tumor
high grade serous carcinoma	HIGH GRADE OVARIAN SEROUS ADENOCARCINOMA
gastric cancer (caucasian)	GASTRIC CANCER
lung adenocarcinoma family history 1st degree relative breast ca 2nd degree relative liposarcoma location of known metastases kidneytumor gradestage stage iv ajcc	LUNG ADENOCARCINOMA
metastasis larynx	Laryngeal Cancer
adenocarcinoma - small intest location of primary tumor duodenumlocation of distant metastases peritoneum	SMALL INTESTINAL ADENOCARCINOMA
leiomyosarcoma - uterus location of known metastatic sites abdomen	Uterine Corpus Leiomyosarcoma
prostate cancer nos location of known metastases liver	Prostate Cancer
squamous cell lung carcinoma moderately differentiated invasive final pathology dx confirmed lymphovascular invasion present 711 hilar lymph nodes positive for metastatic tumor location of known metastases lymph nodes	Lung Squamous Cell Carcinoma
squamous cell carcinoma	Bladder Squamous Cell Carcinoma
head and neck squamous cell carcinoma	Hard Palate Squamous Cell Carcinoma
non-hodgkin lymphoma	Non-Hodgkin Lymphoma
poorly differentiated pancreatic ductal adenocarcinoma	Pancreatic Poorly Differentiated Ductal Adenocarcinoma
adenocarcinoma - rectum pathology dx confirmed tumor stagegrade t3n0m1a, well-differentiatedlocation of primary tumor sigmoid and rectumlocation of known metastases liver	RECTAL ADENOCARCINOMA
transitional cell carcinoma t3bnxmx	Transitional Cell Carcinoma
ductal breast carcinoma	BREAST DUCTAL CARCINOMA
sarcomatoid mesothelioma	PLEURAL SARCOMATOID MESOTHELIOMA
gastrointestinal stromal tumor	Advanced Gastrointestinal Stromal Tumor
adenocarcinoma - colon str and wes match model 969473-103-r, colon primary collected 42016 tumor gradestage iiia, recurrent diseaseprimary tumor location distal sigmoid colon invasive, well-differentiated at diagnosislocation of known metastases liver	COLON ADENOCARCINOMA
down syndrome acute lymphocytic leukemia	ACUTE LYMPHOBLASTIC LEUKEMIA
adenocarcinoma - rectum final pathology dx confirmed with invasive growth through muscularis propria coexisting tubulovillous adenoma present treatment effect present but viable residual cancer still present pr score 2 tumor gradestage ypt2pn0pmx low-grade, moderately differentiated	RECTAL ADENOCARCINOMA
